sent_id	left_context	pivot	right_context
FQB_CAF-2	Puis-je 	avoir	 une aide au logement ? 
FQB_CAF-3	Quelles démarches dois-je effectuer pour 	avoir	 droit à une aide au logement ? 
FQB_CAF-3	Quelles démarches dois-je 	effectuer	 pour avoir droit à une aide au logement ? 
FQB_CAF-7	Quels sont les revenus pris en compte pour 	calculer	 mon aide au logement ? 
FQB_CAF-9	Puis-je bénéficier d'une aide au logement si je 	loue	 un logement appartenant à un membre de ma famille ? 
FQB_CAF-11	Je déménage, vais-je continuer à 	toucher	 le même montant d'aide au logement ? 
FQB_CAF-13	Je n'arrive plus à payer mon loyer ou mon prêt, la Caf peut elle m'	aider	 ? 
FQB_CAF-13	Je n'arrive plus à 	payer	 mon loyer ou mon prêt, la Caf peut elle m'aider ? 
FQB_CAF-15-pre	Je suis étudiant et je cherche une aide pour 	payer	 mon logement. 
FQB_CAF-15-pre	Je suis étudiant et je 	cherche	 une aide pour payer mon logement. 
FQB_CAF-16	Comment la Caf peut-elle m'	aider	 ? 
FQB_CAF-20	Puis-je bénéficier d'une aide au logement si je 	loue	 un logement appartenant à un membre de ma famille ? 
FQB_CAF-21	Quelles démarches dois-je effectuer pour 	demander	 et recevoir une aide au logement ? 
FQB_CAF-21	Quelles démarches dois-je 	effectuer	 pour demander et recevoir une aide au logement ? 
FQB_CAF-29-pre	Je quitte mon logement durant les vacances d'été pour le 	reprendre	 en septembre. 
FQB_CAF-29-pre	Je 	quitte	 mon logement durant les vacances d'été pour le reprendre en septembre. 
FQB_CAF-30	Dois-je 	faire	 une nouvelle demande ? 
FQB_CAF-31-pre	Je vais devenir salarié et je 	garde	 le même logement. 
FQB_CAF-32	Vais-je continuer à 	percevoir	 l'aide au logement étudiant ? 
FQB_CAF-34		Ai	-je droit à l'aide au logement étudiant ? 
FQB_CLEF03-5	Combien d'étages 	ont	 les tours jumelles ? 
FQB_CLEF03-6	Où la troupe "FreightTrain Shakespeare" 	présente	-t-elle "Henry V" ? 
FQB_CLEF03-10	Dans combien de pays Greenpeace 	a	-t-elle des agences ? 
FQB_CLEF03-11	Quel succès d'Elvis Presley Gilmore a-t-il 	chanté	 ? 
FQB_CLEF03-12	Dans quel pays 	trouve	-t-on les concours buzkhashi ? 
FQB_CLEF03-13	Qui a 	remporté	 un titre de champion de boxe à l'échelle de l'état en 1990 ? 
FQB_CLEF03-14	Quel montant une commission de transport de comté en Californie a-t-elle 	consacré	 pour l'achat de téléphones destinés à des handicapés ? 
FQB_CLEF03-15	À quelle époque Gunnar Myrdal a-t-il 	écrit	 "Le dilemme américain" ? 
FQB_CLEF03-18	Combien de condoms a-t-on 	vendu	 au Japon en 1991 ? 
FQB_CLEF03-19	Quel parti Occhetto 	dirigeait	-il ? 
FQB_CLEF03-21	Qui a 	peint	 "Le hurlement" ? 
FQB_CLEF03-23	Combien y 	a	-t-il de mégaoctets dans un gigaoctet ? 
FQB_CLEF03-24	Combien d'îles 	forment	 l'Indonésie ? 
FQB_CLEF03-26	Quelle substance radioactive a-t-on 	injectée	 à Eda Charlton en 1945 ? 
FQB_CLEF03-27	Qui a 	inventé	 la radio ? 
FQB_CLEF03-28	Quel est le nom de la compagnie qui a rappelé un grand nombre de voitures afin de 	régler	 des problèmes mécaniques ? 
FQB_CLEF03-28	Quel est le nom de la compagnie qui a 	rappelé	 un grand nombre de voitures afin de régler des problèmes mécaniques ? 
FQB_CLEF03-29-inf		Donner	 le nom d'un politicien communiste chinois. 
FQB_CLEF03-34	Combien d'actes de piraterie routière a-t-on 	recensé	 à Los Angeles en 1991 ? 
FQB_CLEF03-36	À quel moment l'invasion de la Baie des Cochons a-t-elle 	eu	 lieu ? 
FQB_CLEF03-39	Qui a 	fondé	 les services de santé FHP ? 
FQB_CLEF03-41	Quelle compagnie 	produit	 des cigarettes avec ce qui est appelé le Y-1 ? 
FQB_CLEF03-42	À quelle fleur la Première Dame Hillary Rodham Clinton a-t-elle 	légué	 son nom ? 
FQB_CLEF03-44	À quel endroit a-t-on 	utilisé	 les avions militaires Strike Eagles en 1990 ? 
FQB_CLEF03-46	Que 	signifie	 "kain ayinhore" ? 
FQB_CLEF03-50	À quelle date a-t-on 	approuvé	 la Loi sur les armes à feux ? 
FQB_CLEF03-56	Quel autre nom 	donne	-t-on à la "maladie de la vache folle" ? 
FQB_CLEF03-57	Quel est l'état indien qui 	a	 le plus grand nombre d'habitants ? 
FQB_CLEF03-58-inf		Donner	 le titre d'un poème composé par Mussorgsky. 
FQB_CLEF03-60	Qui John J. Famalaro est-il accusé d'avoir 	tué	 ? 
FQB_CLEF03-61	À quelle époque la Guerre du Golfe a-t-elle 	eu	 lieu ? 
FQB_CLEF03-65-inf		Donner	 le titre d'une chanson de Nirvana. 
FQB_CLEF03-66	Quel nom 	portait	 les anciens services secrets en Albanie ? 
FQB_CLEF03-69	Où a 	eu	 lieu la Coupe d'Amérique en 1991 ? 
FQB_CLEF03-71	Où a 	eu	 lieu la Conférence internationale sur la population ? 
FQB_CLEF03-73	Où a 	eu	 lieu le premier Championnat international de ski de fond ? 
FQB_CLEF03-75	À quelle époque a-t-on 	fondé	 l'orchestre symphonique de Bombay ? 
FQB_CLEF03-76	Combien de salles de classe a-t-on 	construites	 en 1976 dans le district scolaire de Wilsona ? 
FQB_CLEF03-77	Quand Hernando Cortès a-t-il 	atteint	 l'empire aztèque ? 
FQB_CLEF03-79	Combien d'Oscars le film "Sur les quais" a-t-il 	remportés	 ? 
FQB_CLEF03-81-inf		Donner	 le titre d'un poème de Eugenio Montale. 
FQB_CLEF03-82	Qui a 	remporté	 l'Oscar pour "La belle et la bête" ? 
FQB_CLEF03-89	Quelle est l'amende la plus élevée qu'on peut 	imposer	 à un conspirateur ? 
FQB_CLEF03-90-inf		Donner	 le titre d'une ouverture de Berlioz. 
FQB_CLEF03-92	Combien y 	avait	-il d'étudiants japonais aux États-Unis en 1990 ? 
FQB_CLEF03-93	Qui 	dirige	 le groupe religieux japonais Aum Shinrikyo ? 
FQB_CLEF03-94	Quand le pilote d'essai Chuch Yeager a-t-il 	brisé	 le mur du son ? 
FQB_CLEF03-96	À qui Shostakovitch a-t-il 	dédié	 son quatuor à cordes no 8 ? 
FQB_CLEF03-97	Que 	signifie	 l'acronyme "PERS" ? 
FQB_CLEF03-103	Combien de personnes aux États-Unis n'	ont	 pas d'assurance santé ? 
FQB_CLEF03-104	En quelle année Avery Clayton a-t-il été embauché pour 	peindre	 des murales à l'occasion des jeux olympiques d'été ? 
FQB_CLEF03-105	Quel réseau Peter Tortorici 	préside	-t-il ? 
FQB_CLEF03-108	En quelle année Innsbruck a-t-elle 	accueilli	 les jeux olympiques d'hiver ? 
FQB_CLEF03-110	Quel est le réseau qui, le premier, a 	diffusé	 la minisérie "Holocauste" de Steven Spielberg ? 
FQB_CLEF03-111	Quelle association Hope Holcomb 	dirige	-t-elle ? 
FQB_CLEF03-112	Qui a 	fondé	 le club de striptease Chippendale ? 
FQB_CLEF03-116	Pour quel film Robert Bresson a-t-il 	remporté	 le Grand Prix à Cannes ? 
FQB_CLEF03-118	Quel est le nom de la station de métro où a 	eu	 lieu l'attaque au sarin à Tokyo ? 
FQB_CLEF03-121	Combien y 	avait	-il de Texans qui ont combattu pour l'indépendance à l'Alamo ? 
FQB_CLEF03-122	Combien y 	a	-t-il d'habitants au Viêt-nam ? 
FQB_CLEF03-123	Qui Miguel Indurain a-t-il 	épousé	 ? 
FQB_CLEF03-129	Qui a 	écrit	 "L'archipel du Goulag" ? 
FQB_CLEF03-131	Combien y 	a	-t-il d'habitants à Kanazawa ? 
FQB_CLEF03-136	À quelle époque les Raiders ont-ils 	quitté	 Oakland ? 
FQB_CLEF03-140	Qui a 	remporté	 la Coupe Breeders en 1993 ? 
FQB_CLEF03-146	Que 	signifie	 l'abréviation GIA ? 
FQB_CLEF03-149	Quel est le nom de l'organisme que 	soutient	 Vanessa Redgrave ? 
FQB_CLEF03-151-inf		Donner	 le nom d'une équipe pour laquelle Tim Crews a joué. 
FQB_CLEF03-156	Quel est le réseau qui a 	obtenu	 un contrat avec la Ligue nationale de football ? 
FQB_CLEF03-157	Quel a été le premier film qu'a 	dirigé	 John Milius ? 
FQB_CLEF03-158	Quel est le nom de la compagnie qui a 	fabriqué	 le satellite PAS-2 ? 
FQB_CLEF03-159	Quelle compagnie Michael J. Davis 	dirige	-t-il ? 
FQB_CLEF03-160-inf		Donner	 le nom d'un philosophe allemand. 
FQB_CLEF03-161	Quelle chaîne de restauration rapide a 	réduit	 le prix du hamburger Big Mac ? 
FQB_CLEF03-162	Que 	symbolisent	 les "flèches circulaires" ? 
FQB_CLEF03-163	Que 	signifie	 NEO ? 
FQB_CLEF03-165	Où Ayrton Senna a-t-il eu l'accident qui a 	entraîné	 sa mort ? 
FQB_CLEF03-165	Où Ayrton Senna a-t-il 	eu	 l'accident qui a entraîné sa mort ? 
FQB_CLEF03-166	Quel est le mois où est entré en vigueur l'embargo de l'ONU sur le pétrole 	visant	 Haïti ? 
FQB_CLEF03-167	Quel parti Giovanni Spadolini a-t-il 	dirigé	 ? 
FQB_CLEF03-170	Combien de pièces d'artillerie les Serbes ont-ils 	lancées	 sur Sarajevo le jour de Noël ? 
FQB_CLEF03-173	Combien de Tchétchènes Staline a-t-il 	déportés	 ? 
FQB_CLEF03-174	Quelle école Max Bill a-t-il 	fréquentée	 ? 
FQB_CLEF03-176	Qui a 	fondé	 la Nation de l'Islam ? 
FQB_CLEF03-177	Quel âge Burt Lancaster 	avait	-il au moment de sa mort ? 
FQB_CLEF03-180	Quel âge 	avait	 Howard Caine au moment de sa mort ? 
FQB_CLEF03-183-inf		Donner	 le nom d'une chaîne de radio chrétienne. 
FQB_CLEF03-186	Quel âge Deng Xiaoping 	a	-t-il ? 
FQB_CLEF03-187	Quel acteur a 	tenu	 le rôle titre dans le film "Ben-Hur" ? 
FQB_CLEF03-192	Combien de meurtres 	commet	-on en moyenne chaque fin de semaine dans le comté de Los Angeles ? 
FQB_CLEF03-193	Combien a-t-on 	fait	 de prisonniers lord de la prise du Fort Niagara en 1813 ? 
FQB_CLEF03-195	Quel âge Pearl Primus 	avait	-elle au moment de sa mort ? 
FQB_CLEF03-196	à quel moment Elvis Presley a-t-il 	enregistré	 son premier disque ? 
FQB_CLEF03-199	Qui a dit : "Laissez Yeltsin prendre sa vodka et la Tchétchénie 	obtenir	 sa liberté" ? 
FQB_CLEF03-199	Qui a dit : "Laissez Yeltsin 	prendre	 sa vodka et la Tchétchénie obtenir sa liberté" ? 
FQB_CLEF03-199	Qui a dit : "	Laissez	 Yeltsin prendre sa vodka et la Tchétchénie obtenir sa liberté" ? 
FQB_CLEF03-200	Combien de parties consécutives le Penn State a-t-il 	gagnées	 ? 
FQB_INSEE-2	Comment 	reconnaître	 l'agent recenseur ? 
FQB_INSEE-3	Que se 	passe	-t-il en cas d'absence ? 
FQB_INSEE-4	Comment l'agent recenseur 	récupère	-t-il les questionnaires ? 
FQB_INSEE-5	Je n'ai pas vu l'agent recenseur, à qui dois-je m'	adresser	 ? 
FQB_INSEE-5	Je n'ai pas 	vu	 l'agent recenseur, à qui dois-je m'adresser ? 
FQB_INSEE-10	Je n'ai pas été recensé malgré un avis de passage de l'Insee, à qui le 	signaler	 ? 
FQB_INSEE-11	Pourquoi dois-je 	donner	 mon nom et mon prénom alors que l'enquête est anonyme ? 
FQB_INSEE-12	J'ai contracté un Pacs : comment dois-je 	remplir	 mon questionnaire ? 
FQB_INSEE-12	J'ai 	contracté	 un Pacs : comment dois-je remplir mon questionnaire ? 
FQB_INSEE-13	Pourquoi 	demander	 le nom et l'adresse de l'employeur ? 
FQB_INSEE-16	Peut-on 	rectifier	 son bulletin en cas d'erreur ? 
FQB_INSEE-20	J'ai une résidence secondaire, où dois-je me faire 	recenser	 ? 
FQB_INSEE-20	J'	ai	 une résidence secondaire, où dois-je me faire recenser ? 
FQB_INSEE-21	Un de mes enfants loge dans une autre ville pour ses études, doit-il 	remplir	 un bulletin individuel ? 
FQB_INSEE-22	Mon conjoint est absent pendant la semaine pour raisons professionnelles, doit-il 	remplir	 un bulletin individuel ? 
FQB_INSEE-23	J'ai la garde alternée de mes enfants, dois-je 	remplir	 un bulletin individuel pour eux ? 
FQB_INSEE-23	J'	ai	 la garde alternée de mes enfants, dois-je remplir un bulletin individuel pour eux ? 
FQB_INSEE-24	Quand 	connaîtra	-t-on les résultats du recensement ? 
FQB_Impots-1	J'ai perdu mon avis d'imposition, puis-je 	obtenir	 un duplicata ? 
FQB_Impots-1	J'ai 	perdu	 mon avis d'imposition, puis-je obtenir un duplicata ? 
FQB_Impots-2	Je souhaite savoir comment 	retrouver	 mon taux marginal d'imposition à l'impôt sur le revenu ? 
FQB_Impots-3	Je 	constate	 une erreur dans le calcul de mon impôt sur le revenu : comment procéder pour que celle-ci soit corrigée ? 
FQB_Impots-5	Puis-je 	obtenir	 un étalement du paiement de mon impôt en cas de baisse importante de mes revenus ? 
FQB_Impots-7-pre	Je viens de constater que mon avis d'imposition ne 	contient	 pas mes prélèvements d'impôt mensuels. 
FQB_Impots-8	Que dois-je 	faire	 ? 
FQB_Impots-9	Peut-on se mensualiser pour 	régler	 ses contributions sociales ? 
FQB_Impots-10	Que puis-je faire si je 	rencontre	 des difficultés pour le paiement de mon impôt sur le revenu, ma taxe d'habitation ou ma taxe foncière ? 
FQB_Impots-10	Que puis-je 	faire	 si je rencontre des difficultés pour le paiement de mon impôt sur le revenu, ma taxe d'habitation ou ma taxe foncière ? 
FQB_Impots-11	J'ai reçu un chèque et je voudrais savoir si je peux 	obtenir	 cette somme en espèces ? 
FQB_Impots-11	J'ai 	reçu	 un chèque et je voudrais savoir si je peux obtenir cette somme en espèces ? 
FQB_Impots-13		Ai	-je droit à la Prime pour l'Emploi (PPE) ? 
FQB_Impots-14	Quand et comment va-t-on me 	verser	 la prime pour l'emploi ? 
FQB_Impots-15	Je viens de déménager et, je n'ai pas reçu mon chèque pour la prime pour l'emploi, comment faire pour l'	obtenir	 ? 
FQB_Impots-15	Je viens de déménager et, je n'ai pas 	reçu	 mon chèque pour la prime pour l'emploi, comment faire pour l'obtenir ? 
FQB_Impots-17	Je ne 	trouve	 pas la prime pour l'emploi sur mon avis d'impôt, pourquoi ? 
FQB_Impots-18	Mon salaire est inférieur à 17 451 euros et je n'	ai	 pas droit à la prime pour l'emploi, pourquoi ? 
FQB_Impots-19	Je suis célibataire et apprenti, 	ai	-je droit à la prime pour l'emploi ? 
FQB_Impots-20	Je viens de déménager, quelles démarches dois-je 	effectuer	 auprès des services fiscaux ? 
FQB_Impots-21	Je suis célibataire, divorcé, séparé ou veuf et je n'	ai	 plus d'enfant à charge : puis-je bénéficier d'une ½ part supplémentaire ? 
FQB_Impots-22	J'ai un enfant célibataire majeur, quelles sont les conditions pour le 	rattacher	 à ma déclaration de revenus ? 
FQB_Impots-22	J'	ai	 un enfant célibataire majeur, quelles sont les conditions pour le rattacher à ma déclaration de revenus ? 
FQB_Impots-24	Si je loue une ou plusieurs pièces de ma résidence principale, comment dois-je 	déclarer	 ce revenu ? 
FQB_Impots-24	Si je 	loue	 une ou plusieurs pièces de ma résidence principale, comment dois-je déclarer ce revenu ? 
FQB_Impots-25	Comment 	déclarer	 les revenus provenant de la location d'un logement meublé ? 
FQB_Impots-26	Comment dois-je 	déclarer	 les loyers provenant de la location d'un bien immobilier vide ? 
FQB_Impots-27	Comment 	déclarer	 les revenus provenant de mon activité d'auto-entrepreneur ? 
FQB_Impots-31	Si quelqu'un vient travailler chez moi, 	ai	-je droit à une réduction d'impôt ? 
FQB_Impots-32-pre	J'ai 	acheté	 un logement. 
FQB_Impots-33	Puis-je 	déduire	 les intérêts d'emprunt liés à cet achat ? 
FQB_Impots-34	Ai-je droit à une réduction d'impôt pour mes enfants 	poursuivant	 des études ? 
FQB_Impots-34		Ai	-je droit à une réduction d'impôt pour mes enfants poursuivant des études ? 
FQB_Impots-35	Je suis dans l'obligation de prendre mes repas à l'extérieur de mon domicile, que puis-je 	déduire	 ? 
FQB_Impots-35	Je suis dans l'obligation de 	prendre	 mes repas à l'extérieur de mon domicile, que puis-je déduire ? 
FQB_Impots-36	Que puis-je 	déduire	 de mes revenus au titres des pensions alimentaires versées à mes enfants ? 
FQB_Impots-38	Je n'arrive plus à accéder à mon "espace personnel", que puis-je 	faire	 ? 
FQB_Impots-39	J'ai égaré mes identifiants me permettant d'accéder à mon espace personnel, comment puis-je les 	obtenir	 ? 
FQB_Impots-39	J'ai 	égaré	 mes identifiants me permettant d'accéder à mon espace personnel, comment puis-je les obtenir ? 
FQB_Impots-40	Comment 	consulter	 et imprimer les avis de taxe foncière ou de taxe d'habitation de toutes mes résidences ? 
FQB_Impots-42-pre	J'ai 	changé	 d'adresse de messagerie éléctronique. 
FQB_Impots-44	à quelle date vais-je 	recevoir	 mon avis de Taxe Foncière ? 
FQB_Impots-45-pre	J'ai 	reçu	 un avis de contribution sociale. 
FQB_Impots-48	Est-ce que je dois 	régler	 malgré tout son montant à la date limite de paiement ? 
FQB_Impots-49	J'	ai	 plus de 75 ans, suis-je exonéré de Taxe Foncière ? 
FQB_Impots-50	Je suis non imposable à l'impôt sur le revenu, j'ai 	reçu	 un avis de taxe foncière, est-ce normal ? 
FQB_Impots-51	J'ai fait construire une maison, 	ai	-je droit à une exonération de taxe foncière ? 
FQB_Impots-51	J'ai fait 	construire	 une maison, ai-je droit à une exonération de taxe foncière ? 
FQB_Impots-53	Je vais installer une piscine, cela va t-il 	modifier	 le montant de ma taxe foncière ? 
FQB_Impots-53	Je vais 	installer	 une piscine, cela va t-il modifier le montant de ma taxe foncière ? 
FQB_Impots-54	à quelle date vais je 	recevoir	 mon avis de taxe d'habitation ? 
FQB_Impots-56	Je suis non imposable à l'impôt sur le revenu, vais-je 	payer	 une taxe d'habitation 
FQB_Impots-57	Je perçois le RSA, dois je 	payer	 ma taxe d'habitation ? 
FQB_Impots-57	Je 	perçois	 le RSA, dois je payer ma taxe d'habitation ? 
FQB_Impots-58-pre	J'ai reçu une taxe d'habitation pour un logement que je n'	habite	 plus. 
FQB_Impots-58-pre	J'ai 	reçu	 une taxe d'habitation pour un logement que je n'habite plus. 
FQB_Impots-59	Que dois-je 	faire	 ? 
FQB_Impots-60	Je n'ai pas de téléviseur mais un ordinateur avec une carte télévision, dois-je 	payer	 la contribution à l'audiovisuel public ? 
FQB_Impots-60	Je n'	ai	 pas de téléviseur mais un ordinateur avec une carte télévision, dois-je payer la contribution à l'audiovisuel public ? 
FQB_Impots-61	Je n'ai pas de téléviseur, que dois-je faire pour le signaler et pour ne pas 	payer	 de contribution à l'audiovisuel public ? 
FQB_Impots-61	Je n'ai pas de téléviseur, que dois-je faire pour le 	signaler	 et pour ne pas payer de contribution à l'audiovisuel public ? 
FQB_Impots-61	Je n'ai pas de téléviseur, que dois-je 	faire	 pour le signaler et pour ne pas payer de contribution à l'audiovisuel public ? 
FQB_Impots-61	Je n'	ai	 pas de téléviseur, que dois-je faire pour le signaler et pour ne pas payer de contribution à l'audiovisuel public ? 
FQB_Impots-62	Je suis étudiant et je 	loue	 un logement, suis-je redevable de la taxe d'habitation ? 
FQB_Impots-63	Combien puis-je donner à mes enfants et à mes petits enfants sans 	payer	 de droits ? 
FQB_Impots-63	Combien puis-je 	donner	 à mes enfants et à mes petits enfants sans payer de droits ? 
FQB_Impots-64	J'ai réalisé une plus-value sur la vente d'un logement qui n'est pas ma résidence principale, 	ai	-je droit à des abattements ? 
FQB_Impots-64	J'ai 	réalisé	 une plus-value sur la vente d'un logement qui n'est pas ma résidence principale, ai-je droit à des abattements ? 
FQB_Impots-65	Je vais vendre une maison, vais-je 	payer	 un impôt ? 
FQB_Impots-65	Je vais 	vendre	 une maison, vais-je payer un impôt ? 
FQB_Impots-66	J'ai un impôt à payer sur une plus-value immobilière, puis-je 	déduire	 les travaux effectués dans ce logement ? 
FQB_Impots-66	J'	ai	 un impôt à payer sur une plus-value immobilière, puis-je déduire les travaux effectués dans ce logement ? 
FQB_Impots-68	Que 	faire	 si vous êtes exonéré ? 
FQB_Impots-69	Comment 	obtenir	 un duplicata du récépissé ? 
FQB_Impots-70	Qui 	contacter	 pour un renseignement sur les impôts ? 
FQB_Impots-71	Comment puis-je, en tant que particulier, obtenir un certificat (ou quitus fiscal) lorsque j'ai 	acheté	 un véhicule dans un pays de l'union européenne ? 
FQB_Impots-71	Comment puis-je, en tant que particulier, 	obtenir	 un certificat (ou quitus fiscal) lorsque j'ai acheté un véhicule dans un pays de l'union européenne ? 
FQB_Impots-72	Que dois-je 	faire	 auprès de vos services en cas de décès de l'un de mes parents ? 
FQB_Impots-73	Où 	trouver	 les coordonnées de mon service des impôts des particuliers, de mon centre des impôts ou de ma trésorerie ? 
FQB_Impots-74-pre	J'	ai	 besoin d'un bordereau de situation fiscale. 
FQB_Impots-75	Comment l'	obtenir	 ? 
FQB_Impots-76	Où puis-je 	trouver	 mon numéro fiscal ? 
FQB_PoleEmploi-2	Comment 	utiliser	 un flash code (ou QR code) présent sur le site ou des affiches ? 
FQB_PoleEmploi-3	Pourquoi 	mettre	 à jour l'application ? 
FQB_PoleEmploi-5	Pourquoi devez-vous 	avoir	 un espace personnel ? 
FQB_PoleEmploi-8	Vous venez de 	valider	 votre demande d'inscription en ligne, quelles sont les prochaines étapes ? 
FQB_PoleEmploi-9-pre	Vous avez 	effectué	 votre demande d'inscription sur Internet. 
FQB_PoleEmploi-10	Pourquoi n'avez-vous pas 	reçu	 de rendez-vous ? 
FQB_PoleEmploi-11	Vous avez remboursé un trop perçu, devez-vous le 	déduire	 ? 
FQB_PoleEmploi-11	Vous avez 	remboursé	 un trop perçu, devez-vous le déduire ? 
FQB_PoleEmploi-12	Devez-vous 	déclarer	 vos allocations ? 
FQB_PoleEmploi-13	Comment connaître le montant que vous devez 	déclarer	 ? 
FQB_PoleEmploi-13	Comment 	connaître	 le montant que vous devez déclarer ? 
FQB_PoleEmploi-15	Comment 	créer	 un espace personnel lorsque vous n'êtes pas demandeur d'emploi ? 
FQB_PoleEmploi-16	Vous êtes inscrit en tant que demandeur d'emploi et vous souhaitez 	créer	 votre dossier de recherche d'emploi ? 
FQB_PoleEmploi-17	Comment 	déposer	 une réclamation ? 
FQB_PoleEmploi-21	Où 	trouver	 des informations sur les droits des intermittents du spectacle ? 
FQB_PoleEmploi-23	Vous êtes intermittent du spectacle et vous rencontrez des difficultés pour 	déclarer	 vos périodes d'emploi 
FQB_PoleEmploi-23	Vous êtes intermittent du spectacle et vous 	rencontrez	 des difficultés pour déclarer vos périodes d'emploi 
FQB_PoleEmploi-25	Vous avez oublié votre mot de passe et/ou votre identifiant : comment les 	récupérer	 ? 
FQB_PoleEmploi-25	Vous avez 	oublié	 votre mot de passe et/ou votre identifiant : comment les récupérer ? 
FQB_PoleEmploi-30	Y - a-t-il des situations d'emploi qui 	autorisent	 des critères apparemment discriminatoires ? 
FQB_PoleEmploi-30	Y - 	a	-t-il des situations d'emploi qui autorisent des critères apparemment discriminatoires ? 
FQB_TREC-fr-3	Que 	produit	 la compagnie Peugeot ? 
FQB_TREC-fr-4	En 1993, quelle somme a 	dépensé	 Mercury en publicité ? 
FQB_TREC-fr-6	Pourquoi David Koresh a-t-il 	demandé	 un système de traitement de texte au FBI ? 
FQB_TREC-fr-7	Quelles dettes le groupe Qintex a-t-il 	laissées	 ? 
FQB_TREC-fr-8	Quel est le nom de la maladie neurologique rare qui 	présente	 des symptômes tels que des mouvements involontaires (des tics), l'usage de jurons et des vocalisations incohérentes (des grognements, des cris, etc.) ? 
FQB_TREC-fr-10-imp	Nommez le créateur du soulier qui a 	entraîné	 des millions d'imitations en plastique, connues sous le noms de "souliers Jelly". 
FQB_TREC-fr-10-imp		Nommez	 le créateur du soulier qui a entraîné des millions d'imitations en plastique, connues sous le noms de "souliers Jelly". 
FQB_TREC-fr-12	Quelle somme Manchester United a-t-elle 	dépensé	 sur des joueurs en 1993 ? 
FQB_TREC-fr-16	Quels sont les deux biochimistes américains ayant 	gagné	 le prix Nobel de médecine en 1992 ? 
FQB_TREC-fr-22	Quand la période du jurassique a-t-elle 	pris	 fin ? 
FQB_TREC-fr-23	Quand l'Espagne et la Corée ont-elles 	entamé	 des relations ambassadoriales ? 
FQB_TREC-fr-24	Quand Nixon a-t-il 	visité	 la Chine ? 
FQB_TREC-fr-26	Quel est le nom du versant "féminin" d'El Niño, qui a comme résultat de refroidir la température et d'	entraîner	 un climat sec ? 
FQB_TREC-fr-26	Quel est le nom du versant "féminin" d'El Niño, qui a comme résultat de 	refroidir	 la température et d'entraîner un climat sec ? 
FQB_TREC-fr-32	Qui a 	reçu	 le prix Will Rogers en 1989 ? 
FQB_TREC-fr-40	Qui a 	gagné	 le prix Nobel de la paix en 1991 ? 
FQB_TREC-fr-43	Quel costumier a décidé que Michael Jackson ne devrait 	porter	 qu'un seul gant ? 
FQB_TREC-fr-44	Qui est directeur du groupe international nommé l'Organisation du génome humain (hugo) qui tente présentement de 	coordonner	 à travers le monde la recherche portant sur la carte du génome humain ? 
FQB_TREC-fr-49	Qui a 	renvoyé	 Maria Ybarra de son poste au conseil municipal de San Diego ? 
FQB_TREC-fr-52	Qui a 	inventé	 le cône en plastique servant à la circulation routière ? 
FQB_TREC-fr-53	Qui fut le premier médecin à 	réussir	 la transplantation d'un foie ? 
FQB_TREC-fr-56	Combien de calories y 	a	-t-il dans un Big Mac ? 
FQB_TREC-fr-57	Quel est l'acronyme du système qui 	évalue	 l'efficacité de l'air climatisé ? 
FQB_TREC-fr-58-imp	Nommez un film ayant 	remporté	 l'Ours d'or au Festival du Film de Berlin. 
FQB_TREC-fr-58-imp		Nommez	 un film ayant remporté l'Ours d'or au Festival du Film de Berlin. 
FQB_TREC-fr-60	Combien 	coûte	 un voyage aller-retour New York - Londres sur le Concorde ? 
FQB_TREC-fr-62	Quel est le nom de la maladie neurologique chronique auto-immunitaire qui attaque l'enveloppe entourant les cellules nerveuses, 	causant	 ainsi une perte graduelle du mouvement dans le corps ? 
FQB_TREC-fr-62	Quel est le nom de la maladie neurologique chronique auto-immunitaire qui attaque l'enveloppe 	entourant	 les cellules nerveuses, causant ainsi une perte graduelle du mouvement dans le corps ? 
FQB_TREC-fr-62	Quel est le nom de la maladie neurologique chronique auto-immunitaire qui 	attaque	 l'enveloppe entourant les cellules nerveuses, causant ainsi une perte graduelle du mouvement dans le corps ? 
FQB_TREC-fr-64	Qui 	fait	 la voix de Miss Piggy ? 
FQB_TREC-fr-65-imp	Nommez un pays qui 	développe	 un système de rail à lévitation magnétique. 
FQB_TREC-fr-65-imp		Nommez	 un pays qui développe un système de rail à lévitation magnétique. 
FQB_TREC-fr-66-imp	Nommez le premier citoyen privé ayant 	effectué	 un vol dans l'espace. 
FQB_TREC-fr-66-imp		Nommez	 le premier citoyen privé ayant effectué un vol dans l'espace. 
FQB_TREC-fr-68	Que 	signifie	 "El Niño" en espagnol ? 
FQB_TREC-fr-69	Qui a 	forgé	 le terme "El Niño" ? 
FQB_TREC-fr-71	En quelle année Joe DiMaggio a-t-il 	atteint	 sa série de 56 parties avec un coup sûr ? 
FQB_TREC-fr-74	Qui 	dirige	 le vaisseau Enterprise dans Star Trek ? 
FQB_TREC-fr-77	Qui 	jouait	 le rôle du parrain dans le film "The Godfather" ? 
FQB_TREC-fr-78	Quelle grande ville américaine 	connut	 le plus grand nombre de meurtres en 1988 ? 
FQB_TREC-fr-79	Qu'est-ce que Chostakovitch a 	écrit	 pour Rostropovitch ? 
FQB_TREC-fr-81	Combien d'habitants 	compte	 la ville d'Ushuaia ? 
FQB_TREC-fr-82	Combien de parties consécutives de baseball Lou Gehrig a-t-il 	jouées	 ? 
FQB_TREC-fr-84	Quel pays 	forme	 le plus grand marché d'exportation pour l'Australie ? 
FQB_TREC-fr-85	Quel ancien membre du Ku Klux Klan a 	remporté	 un poste élu aux États-Unis ? 
FQB_TREC-fr-86	Qui a 	gagné	 deux médailles d'or en ski aux jeux Olympiques de Calgary ? 
FQB_TREC-fr-89	À quel âge Rossini a-t-il cessé de 	composer	 des opéras ? 
FQB_TREC-fr-91	Quelle ville chinoise 	compte	 le plus grand nombre de compagnies financières étrangères ? 
FQB_TREC-fr-92	Qui 	a	 le premier virus Internet, à la fin des années 1980 ? 
FQB_TREC-fr-93	Quel fut le premier navigateur à 	faire	 le tour du globe ? 
FQB_TREC-fr-94	Qui a 	composé	 la chanson "Stardust" ? 
FQB_TREC-fr-99	Quel terme 	représente	 la somme de tout le matériel génétique présent dans un organisme donné ? 
FQB_TREC-fr-100	Qu'est-ce qui est tenu pour avoir été le désastre financier le plus coûteux que l'industrie de l'assurance ait jamais 	connu	 ? 
FQB_TREC-fr-102	Qui 	assure	 la gestion du projet Voyager ? 
FQB_TREC-fr-105	Combien de gens la compagnie Honda 	emploie	-t-elle aux États-Unis ? 
FQB_TREC-fr-107	Quand 	eut	 lieu le premier test nucléaire chinois ? 
FQB_TREC-fr-108	Quelle compagnie a 	créé	 le navigateur Internet nommé Mosaic ? 
FQB_TREC-fr-109	Où Buzz Aldrin veut-il 	construire	 une station spatiale permanente et habitée ? 
FQB_TREC-fr-110	Qui a 	tué	 Lee Harvey Oswald ? 
FQB_TREC-fr-113	Comment 	nomme	-t-on l'état médical d'un enfant né sans cerveau ? 
FQB_TREC-fr-116	Quelle équipe a 	gagné	 le Super Bowl en 1996 ? 
FQB_TREC-fr-117	Quels sont les deux chercheurs ayant 	découvert	 en 1953 la structure en double hélice de l'ADN ? 
FQB_TREC-fr-120	Qui 	détint	 le record d'endurance pour les femmes pilotes en 1929 ? 
FQB_TREC-fr-121	Qui 	remporta	 la première élection présidentielle générale tenue à Malawi en mai 1994 ? 
FQB_TREC-fr-123	Combien de Viêtnamiens y 	avait	-il en urss ? 
FQB_TREC-fr-126	Quand Israël a-t-il commencé à 	rendre	 la Bande de Gaza et Jéricho à l'olp ? 
FQB_TREC-fr-127	Quelle ville 	a	 la plus vieille relation de ville-soeur avec Los Angeles ? 
FQB_TREC-fr-131	Quel fabricant automobile japonais 	devait	 son plus grand pourcentage de ventes au marché intérieur ? 
FQB_TREC-fr-133	Comment nomme-t-on la technique par laquelle l'on sème certaines plantes dans un sol contaminé aux métaux toxiques afin que ces plantes 	ingèrent	 ces métaux, qu'elles soient récoltées, puis que les métaux soient recouvrés à fins de recyclage ? 
FQB_TREC-fr-133	Comment nomme-t-on la technique par laquelle l'on 	sème	 certaines plantes dans un sol contaminé aux métaux toxiques afin que ces plantes ingèrent ces métaux, qu'elles soient récoltées, puis que les métaux soient recouvrés à fins de recyclage ? 
FQB_TREC-fr-133	Comment 	nomme	-t-on la technique par laquelle l'on sème certaines plantes dans un sol contaminé aux métaux toxiques afin que ces plantes ingèrent ces métaux, qu'elles soient récoltées, puis que les métaux soient recouvrés à fins de recyclage ? 
FQB_TREC-fr-134	Où prévoit-on amarrer le navire de commerce Lane Victory, que des vétérans de la marine marchande 	convertissent	 en musée flottant ? 
FQB_TREC-fr-134	Où prévoit-on 	amarrer	 le navire de commerce Lane Victory, que des vétérans de la marine marchande convertissent en musée flottant ? 
FQB_TREC-fr-138	Comment 	nomme	-t-on le processus normal chez tout être vivant, y compris chez les êtres humains, par lequel des cellules sont programmées à se "suicider" ? 
FQB_TREC-fr-139	Combien de gens les Nations Unies se sont-elles engagées à aider à restaurer l'ordre et à 	distribuer	 de l'aide humanitaire en Somalie en septembre 1992 ? 
FQB_TREC-fr-139	Combien de gens les Nations Unies se sont-elles engagées à aider à 	restaurer	 l'ordre et à distribuer de l'aide humanitaire en Somalie en septembre 1992 ? 
FQB_TREC-fr-139	Combien de gens les Nations Unies se sont-elles engagées à 	aider	 à restaurer l'ordre et à distribuer de l'aide humanitaire en Somalie en septembre 1992 ? 
FQB_TREC-fr-144	Combien de mégawatts 	produira	 en Indonésie le projet énergétique mis sur pied par un consortium mené par Mission Energy des États-Unis ? 
FQB_TREC-fr-145	Qu'a fait John Hinckley pour 	impressionner	 Jodie Foster ? 
FQB_TREC-fr-145	Qu'a 	fait	 John Hinckley pour impressionner Jodie Foster ? 
FQB_TREC-fr-146	En quelle année l'Irlande a-t-elle 	élu	 sa première femme présidente ? 
FQB_TREC-fr-150	Quelle longueur 	fait	 la frontière entre l'Ukraine et la Russie ? 
FQB_TREC-fr-152	Combien d'habitants 	compte	 la ville de Tokyo ? 
FQB_TREC-fr-154	Combien de titres du Grand Slam Bjorn Borg a-t-il 	remportés	 ? 
FQB_TREC-fr-160	Quand les révolutionnaires français ont-ils 	pris	 d'assaut la Bastille ? 
FQB_TREC-fr-165	Quel type de sous-marins la Corée du Nord a-t-elle récemment 	acheté	 ? 
FQB_TREC-fr-166	Quand le contrôle communiste a t-il 	pris	 fin en Hongrie ? 
FQB_TREC-fr-173	Combien de lunes 	possède	 Jupiter ? 
FQB_TREC-fr-176	Combien de personnes y 	a	-t-il à Tucson ? 
FQB_TREC-fr-186	Où a 	eu	 lieu la bataille de la Bulge ? 
FQB_TREC-fr-188	Quand l'amendement 	accordant	 le suffrage aux femmes a-t-il été ratifié ? 
FQB_TREC-fr-194	Qui a 	composé	 "The Pines of Rome" ? 
FQB_TREC-fr-195	Qui a 	écrit	 "Dubliners" ? 
FQB_TREC-fr-196	Qui a 	écrit	 "Hamlet" ? 
FQB_TREC-fr-197	Qu'a dit Richard Feynman lorsqu'il apprit qu'il 	recevrait	 le prix Nobel de physique ? 
FQB_TREC-fr-197	Qu'a 	dit	 Richard Feynman lorsqu'il apprit qu'il recevrait le prix Nobel de physique ? 
FQB_TREC-fr-203	Quelle dose quotidienne d'acide folique une femme enceinte devrait-elle 	obtenir	 ? 
FQB_TREC-fr-208	Quel État 	compte	 le plus d'Indiens ? 
FQB_TREC-fr-210	Combien de chiens faut-il pour 	tirer	 un traîneau dans l'Iditarod ? 
FQB_TREC-fr-210	Combien de chiens 	faut	-il pour tirer un traîneau dans l'Iditarod ? 
FQB_TREC-fr-212	Qui a 	inventé	 la guitare électrique ? 
FQB_TREC-fr-213-imp		Nommez	 un mammifère volant. 
FQB_TREC-fr-221	Qui a 	assassiné	 Martin Luther King ? 
FQB_TREC-fr-224	Que 	signifie	 l'acronyme "laser" ? 
FQB_TREC-fr-232	Qui a 	inventé	 la télévision ? 
FQB_TREC-fr-233	Qui a 	construit	 le premier avion ? 
FQB_TREC-fr-234	Qui a 	construit	 le premier avion pouvant voler ? 
FQB_TREC-fr-237-imp		Nommez	 l'un des dieux principaux de l'hindouisme. 
FQB_TREC-fr-238	Que 	représente	 l'abréviation "OAS" ? 
FQB_TREC-fr-244	Qui a 	inventé	 le baseball ? 
FQB_TREC-fr-245	Où peut-on 	trouver	 l'attrape-mouche de Vénus ? 
FQB_TREC-fr-246	Qu'a 	découvert	 Vasco da Gama ? 
FQB_TREC-fr-247	Qui a 	gagné	 la bataille de Gettysburg ? 
FQB_TREC-fr-251	Combien d'habitants y 	a	-t-il au Chili ? 
FQB_TREC-fr-255	Qui a pensé à enseigner aux gens comment 	nouer	 leurs lacets de chaussure ? 
FQB_TREC-fr-257	Que 	mangent	 les pingouins ? 
FQB_TREC-fr-260	Que 	représente	 l'acronyme NAFTA ? 
FQB_TREC-fr-261	Quelle compagnie 	vend	 le plus de cartes de souhait ? 
FQB_TREC-fr-264	Qui a 	écrit	 le Farmer 's Almanach ? 
FQB_TREC-fr-267	Comment nomme-t-on les nuages qui 	produisent	 de la pluie 
FQB_TREC-fr-267	Comment 	nomme	-t-on les nuages qui produisent de la pluie 
FQB_TREC-fr-268	Qui a 	tué	 César ? 
FQB_TREC-fr-272	Où y 	a	-t-il des aborigènes ? 
FQB_TREC-fr-274	Qui a 	inventé	 le jeu Scrabble ? 
FQB_TREC-fr-276	Combien d'argent 	possède	 le sultan du Brunei ? 
FQB_TREC-fr-278	Combien de morts 	fit	 l'éruption du mont Pinatubo ? 
FQB_TREC-fr-281	Quand Géraldine Ferraro a-t-elle 	posé	 sa candidature comme vice-présidente ? 
FQB_TREC-fr-282	Que 	mangent	 les coccinelles ? 
FQB_TREC-fr-285	Quand la première voie ferrée 	reliant	 la côte est à la côte ouest fut-elle complétée ? 
FQB_TREC-fr-290	Quand l'ouragan Hugo 	eut	-il lieu ? 
FQB_TREC-fr-293	Qui a 	découvert	 Hawaii ? 
FQB_TREC-fr-295	Combien de films Ingmar Bergman a-t-il 	réalisés	 ? 
FQB_TREC-fr-297	Que 	mangeait	 le brontosaure ? 
FQB_TREC-fr-299	Combien d'espèces de lémuriens y 	a	-t-il ? 
FQB_TREC-fr-308	Combien de circuits Babe Ruth a-t-il 	frappés	 dans sa vie ? 
FQB_TREC-fr-311	Combien de Superbowls les Forty-Niners ont-ils 	gagnés	 ? 
FQB_TREC-fr-313	Qui a 	inventé	 le papier ? 
FQB_TREC-fr-316-imp		Nommez	 un tigre dont la race est éteinte. 
FQB_TREC-fr-318	Quel collège Bill Gates a-t-il 	fréquenté	 ? 
FQB_TREC-fr-319	Combien y 	a	-t-il de continents ? 
FQB_TREC-fr-326	Que 	mangent	 les lamantins ? 
FQB_TREC-fr-327	Quand le feu de San Fransisco 	eut	-il lieu ? 
FQB_TREC-fr-332	Combien de temps cela 	prendrait	-il pour aller de la Terre à Mars ? 
FQB_TREC-fr-334	Quel âge 	a	 le Soleil ? 
FQB_TREC-fr-338	Qui a 	inventé	 le basketball ? 
FQB_TREC-fr-348	Qui 	construisit	 la première pyramide ? 
FQB_TREC-fr-352	Qui a 	inventé	 le jeu connu sous le nom de "bowling" ? 
FQB_TREC-fr-353	Quelle culture a introduit dans le monde le système de numérotation que nous 	utilisons	 aujourd'hui ? 
FQB_TREC-fr-353	Quelle culture a 	introduit	 dans le monde le système de numérotation que nous utilisons aujourd'hui ? 
FQB_TREC-fr-360	Combien de milles 	fait	 une course de 10 kilomètres ? 
FQB_TREC-fr-366	Qui a 	remporté	 le Superbowl en 1982 ? 
FQB_TREC-fr-372	Quand 	eut	 lieu l'incendie de la Triangle Shirtwaist ? 
FQB_TREC-fr-381	Qui a 	assassiné	 le président McKinley ? 
FQB_TREC-fr-384	Qui a 	inventé	 la radio ? 
FQB_TREC-fr-385	Où a-t-on le plus de chances de 	trouver	 des zèbres ? 
FQB_TREC-fr-385	Où 	a	-t-on le plus de chances de trouver des zèbres ? 
FQB_TREC-fr-391	Qui a 	peint	 Olympia ? 
FQB_TREC-fr-396	Qui a 	inventé	 le "Silly Putty" ? 
FQB_TREC-fr-398	Quand 	a	 lieu le Boxing Day ? 
FQB_TREC-fr-405	Qui 	faisait	 des automobiles à moteurs rotatifs ? 
FQB_TREC-fr-410	Que 	représente	 l'acronyme anglais "hazmat" ? 
FQB_TREC-fr-411	Quels sites touristiques y 	a	-t-il à Reims ? 
FQB_TREC-fr-412-imp		Nommez	 un film dans lequel a joué Jude Law. 
FQB_TREC-fr-415	Que 	représente	 l'acronyme CNN ? 
FQB_TREC-fr-416	Quand 	eut	 lieu la première transmission de CNN ? 
FQB_TREC-fr-417	Qui 	possède	 CNN ? 
FQB_TREC-fr-423	Quelle boisson gazeuse 	contient	 la plus grande quantité de caféine ? 
FQB_TREC-fr-424	Comment 	nomme	-t-on un groupe d'oies ? 
FQB_TREC-fr-427	Quelle culture a 	développé	 l'idée du potlatch ? 
FQB_TREC-fr-431	Que 	signifie	 l'acronyme "CPR" ? 
FQB_TREC-fr-432	Quel État 	produit	 le meilleur homard pour la consommation ? 
FQB_TREC-fr-441	Quel roi s'est vu forcé d'	accepter	 la Magna Carta ? 
FQB_TREC-fr-444	Où 	a	 lieu l'Orange Bowl ? 
FQB_TREC-fr-445	Quand 	eut	 lieu la dernière éruption majeure du mont Sainte-Hélène ? 
FQB_TREC-fr-446	Par quelle abréviation anglaise 	nomme	-t-on un équipementier ? 
FQB_TREC-fr-449	Que 	fait	 Nicholas Cage comme profession ? 
FQB_TREC-fr-450	Que 	signifie	 "caliente" en anglais ? 
FQB_TREC-fr-452	Qui a 	créé	 les "Muppets" ? 
FQB_TREC-fr-460-imp		Nommez	 une langue gaélique. 
FQB_TREC-fr-462	Qu'est-ce que l'on 	mesure	 en curies ? 
FQB_TREC-fr-469	Qui a 	forgé	 le terme "cyberspace" dans son roman "Neuromancer" ? 
FQB_TREC-fr-473	Qui a 	créé	 le personnage de Scrooge ? 
FQB_TREC-fr-474	Qui fut le premier à 	franchir	 le mur du son ? 
FQB_TREC-fr-476-imp		Nommez	 l'une des sept merveilles de l'Antiquité. 
FQB_TREC-fr-479	Qui 	offre	 le service téléphonique à Orange County, en Californie ? 
FQB_TREC-fr-481	Qui a 	tué	 Billy the Kid ? 
FQB_TREC-fr-486	Combien d'États 	ont	 une loi citron pour les nouvelles automobiles ? 
FQB_TREC-fr-491	Où 	eut	 lieu Woodstock ? 
FQB_TREC-fr-494	Qui a 	écrit	 le livre "The Grinch Who Stole Christmas" ? 
FQB_TREC-fr-495	Quand Aldous Huxley a-t-il 	écrit	 "Brave New World" ? 
FQB_TREC-fr-496	Qui a 	écrit	 le livre "Song of Solomon" ? 
FQB_TREC-fr-497	Qui 	jouait	 le rôle de Jake dans l'émission télévisée intitulée "Jake and the Fatman" ? 
FQB_TREC-fr-498	Qui 	jouait	 le rôle de Fatman dans l'émission télévisée intitulée "Jake and the Fatman" ? 
FQB_TREC-fr-506	Qui 	fait	 la météo dans l'émission télévisée "Good Morning America" ? 
FQB_TREC-fr-513	Quand 	eut	 lieu le mariage du Prince Andrew et de Fergie ? 
FQB_TREC-fr-514	Quelle céréale 	fait	 "cric, crac, croc" ? 
FQB_TREC-fr-515	Pour quelle maladie 	utilise	-t-on le médicament Sinemet ? 
FQB_TREC-fr-518	Dans quelle région du globe a 	eu	 lieu la guerre des Six Jours ? 
FQB_TREC-fr-522	Que 	signifie	 EKG ? 
FQB_TREC-fr-525-imp		Nommez	 un symptôme de la mononucléose. 
FQB_TREC-fr-533	Qui a 	gagné	 la coupe mondiale de rugby en 1987 ? 
FQB_TREC-fr-535	Qui 	jouait	 le personnage de Rosanne Rosanna-Dana dans l'émission télévisée intitulée "Saturday Night Live" ? 
FQB_TREC-fr-543-imp		Nommez	 un champ de bataille de la Guerre civile. 
FQB_TREC-fr-545	Qui a 	écrit	 la chanson "Silent Night" ? 
FQB_TREC-fr-546	Qui a 	joué	 l'homme sans visage dans le film du même titre ? 
FQB_TREC-fr-549	Que 	fait	-on traditionnellement à Noël sous le gui ? 
FQB_TREC-fr-551	Quel est le nom de la peinture de Michel-Ange qui 	représente	 deux mains dont les doigts se touchent ? 
FQB_TREC-fr-552	Qu'est-ce qui a 	causé	 les inondations de Lynmouth ? 
FQB_TREC-fr-553	Quel est le nom de la compagnie qui 	produit	 la collection de poupées "American Girl" ? 
FQB_TREC-fr-554	Combien de codes postaux y 	a	-t-il aux États-Unis ? 
FQB_TREC-fr-559	Qui a 	créé	 le personnage de James Bond ? 
FQB_TREC-fr-560	Pour quel magasin Martha Stewart 	fait	-elle de la publicité ? 
FQB_TREC-fr-561-imp		Nommez	 une motocyclette fabriquée aux États-Unis. 
FQB_TREC-fr-562	Pour quelle compagnie de croisière Kathie Lee Gifford 	fait	-elle de la publicité ? 
FQB_TREC-fr-563-imp		Nommez	 un film dans lequel a joué l'actrice Sandra Bullock. 
FQB_TREC-fr-567-imp		Nommez	 une patineuse artistique. 
FQB_TREC-fr-569	Combien de calcium devrait 	prendre	 une femme adulte quotidiennement ? 
FQB_TREC-fr-571	Quelle couleur de teinture à cheveux devrait-on utiliser pour simplement 	masquer	 un peu de gris ? 
FQB_TREC-fr-571	Quelle couleur de teinture à cheveux devrait-on 	utiliser	 pour simplement masquer un peu de gris ? 
FQB_TREC-fr-572	Combien de temps cela 	prendrait	-il pour que un bon d'épargne de 50 $ arrive à maturité ? 
FQB_TREC-fr-573	Combien de circuits Lou Gehrig a-t-il 	faits	 dans sa carrière ? 
FQB_TREC-fr-574	Combien d'États 	possèdent	 une loterie ? 
FQB_TREC-fr-577	Pouvez-vous me 	nommer	 un horloger de Londres, en Angleterre ? 
FQB_TREC-fr-581	Quelle fleur Vincent Van Gogh a-t-il 	peint	 ? 
FQB_TREC-fr-584	Que 	signifie	 l'acronyme NASA ? 
FQB_TREC-fr-587	Dans quel livre peut-on 	trouver	 l'histoire d'Aladin ? 
FQB_TREC-fr-591	Qui 	possède	 les Rams de St-Louis ? 
FQB_TREC-fr-592	Où pourrait-on 	faire	 un tour de locomotive à vapeur ? 
FQB_TREC-fr-594-imp		Nommez	 un avion de guerre américain. 
FQB_TREC-fr-596	Combien de milles d'autoroute au gallon permet de 	parcourir	 la Fiesta de Ford ? 
FQB_TREC-fr-597-imp		Nommez	 un roman de John Steinbeck. 
FQB_TREC-fr-598	Qui a 	composé	 la chanson "Boys of Summer" ? 
FQB_TREC-fr-602	Qui 	produit	 le logiciel Photoshop ? 
FQB_TREC-fr-603	Combien de casinos y 	a	-t-il à Atlantic City, au New Jersey ? 
FQB_TREC-fr-609	Quand "la Grande dépression" 	eut	-elle lieu ? 
FQB_TREC-fr-612	Qui a 	créé	 la bande dessinée intitulée Garfield ? 
FQB_TREC-fr-614	Qui a 	écrit	 le livre Huckleberry Finn ? 
FQB_TREC-fr-618	Comment nomme-t-on l'art de faire 	pousser	 des arbres miniatures ? 
FQB_TREC-fr-618	Comment 	nomme	-t-on l'art de faire pousser des arbres miniatures ? 
FQB_TREC-fr-620	Qui a 	écrit	 "The Scarlett Letter" ? 
FQB_TREC-fr-621-imp		Nommez	 une galerie d'art de New York. 
FQB_TREC-fr-622	Dans quel type de chasse 	emploie	-t-on des lévriers ? 
FQB_TREC-fr-625	Quand l'accident nucléaire de Tchernobyl a-t-il 	eu	 lieu ? 
FQB_TREC-fr-626	Que 	signifie	 l'acronyme anglais "sids" ? 
FQB_TREC-fr-630	Quelle hauteur 	a	 la Kilimandjaro ? 
FQB_TREC-fr-631	Qui a 	gagné	 le prix Nobel de littérature en 1988 ? 
FQB_TREC-fr-638	Qui a 	écrit	 "The Pit and the Pendulum" ? 
FQB_TREC-fr-639	Qui 	produit	 les électroménagers de marque Magic Chef ? 
FQB_TREC-fr-643	Qui a 	écrit	 "An Ideal Husband" ? 
FQB_TREC-fr-645	Quand le Dow a-t-il 	atteint	 2000 pour la première fois ? 
FQB_TREC-fr-647	Combien de miles y 	a	-t-il entre Londres et Plymouth, en Angleterre ? 
FQB_TREC-fr-649	Qui a 	joué	 le professeur dans "Dead Poet 's Society" ? 
FQB_TREC-fr-650	Combien de comtés y 	a	-t-il en Inde ? 
FQB_TREC-fr-654	Quelle agence gouvernementale américaine 	enregistre	 les marques de commerce ? 
FQB_TREC-fr-655	Qui a 	lancé	 la chaîne de restaurant Dominos Pizza ? 
FQB_TREC-fr-656	Quel est le nom de la coupe de cheveux que 	reçoivent	 les nouvelles recrues militaires ? 
FQB_TREC-fr-657	Dans quel pays est-ce un geste de bienvenue que de 	tirer	 la langue ? 
FQB_TREC-fr-661	Combien 	coûte	 une tonne de ciment ? 
FQB_TREC-fr-663	Combien de gens 	écoutent	 la télévision en réseau ? 
FQB_TREC-fr-670	Dans le monde des sports, à quoi 	fait	 référence "Final Four" ? 
FQB_TREC-fr-671	Que 	publie	 Knight Rider ? 
FQB_TREC-fr-672	Quelle tâche 	accomplit	 la race de chien bouvier ? 
FQB_TREC-fr-676-imp		Nommez	 une troupe de ballet pour laquelle Mikhail Baryshnikov a dansé. 
FQB_TREC-fr-677	Quel était le nom de l'émission télévisée dans laquelle jouait Karl Maden et dont le titre 	renfermait	 "San Fransisco" ? 
FQB_TREC-fr-679	Qu'est-ce que Delilah a 	fait	 aux cheveux de Samson ? 
FQB_TREC-fr-681	Quel fut le premier acteur à 	interpréter	 le rôle de James Bond ? 
FQB_TREC-fr-683	Que 	mangent	 les loutres d'eau douce ? 
FQB_TREC-fr-685	Quand Amtrak a-t-elle 	débuté	 ses opérations ? 
FQB_TREC-fr-689	Combien d'îles 	compte	 Fidji ? 
FQB_TREC-fr-690	Quelle compagnie de cartes 	vend	 des décorations de Noël ? 
FQB_TREC-fr-691	Qui 	fabrique	 la thyroxine ? 
FQB_TREC-fr-692	En quelle année Desmond Mpilo Tutu a-t-il 	reçu	 le prix Nobel de la paix ? 
FQB_TREC-fr-700	Comment 	nomme	-t-on quelqu'un dont la vue est courte ? 
FQB_TREC-fr-709	Que 	signifie	 l'expression anglaise "hazmat" ? 
FQB_TREC-fr-712	Que 	visitent	 la majorité des touristes à Reims ? 
FQB_TREC-fr-713	Qu'est-ce qui 	pousse	 les touristes à aller à Reims ? 
FQB_TREC-fr-715	Que pourrait-on 	voir	 à Reims ? 
FQB_TREC-fr-716	Qu'est-ce qui 	vaut	 la peine d'être vu à Reims ? 
FQB_TREC-fr-717	Que peut-on 	voir	 à Reims ? 
FQB_TREC-fr-724	Où Procter et Gamble 	ont	-ils leurs quartiers généraux aux États-Unis ? 
FQB_TREC-fr-726	Dans quelle ville américaine Procter et Gamble 	ont	-ils leur siège social ? 
FQB_TREC-fr-729	Combien d'acide folique une femme enceinte devrait-elle 	obtenir	 chaque jour ? 
FQB_TREC-fr-729	Combien d'acide folique une femme enceinte devrait-elle 	obtenir	 chaque jour ? 
FQB_TREC-fr-730	Quelle est la quantité quotidienne d'acide folique recommandée pour une femme qui 	attend	 un bébé ? 
FQB_TREC-fr-731	Quelle quantité d'acide folique une femme attendant un bébé devrait-elle 	prendre	 quotidiennement ? 
FQB_TREC-fr-731	Quelle quantité d'acide folique une femme 	attendant	 un bébé devrait-elle prendre quotidiennement ? 
FQB_TREC-fr-732-imp		Nommez	 le premier cosmonaute russe à avoir marché dans l'espace. 
FQB_TREC-fr-738	En quelle année CNN a-t-elle 	commencé	 sa diffusion ? 
FQB_TREC-fr-739	À quelle date 	eut	 lieu la première transmission de CNN ? 
FQB_TREC-fr-740	Quand CNN a-t-elle 	commencé	 sa diffusion ? 
FQB_TREC-fr-744	Quel journal 	dessert	 Salt Lake City ? 
FQB_TREC-fr-745-imp		Nommez	 un journal de Salt Lake City. 
FQB_TREC-fr-749	Qu'est-ce qui a 	rendue	 Jane Goodall célèbre ? 
FQB_TREC-fr-750-imp		Définissez	 "thalassémie". 
FQB_TREC-fr-753	Quelle boisson gazeuse 	a	 la plus haute teneur en caféine ? 
FQB_TREC-fr-754	Quelle est la boisson gazeuse 	ayant	 la plus haute teneur en caféine ? 
FQB_TREC-fr-755	Quelle boisson gazeuse devrait-on boire pour 	avoir	 le plus de caféine ? 
FQB_TREC-fr-755	Quelle boisson gazeuse devrait-on 	boire	 pour avoir le plus de caféine ? 
FQB_TREC-fr-756	Quel type de boisson gazeuse 	contient	 la plus grande quantité de caféine ? 
FQB_TREC-fr-757	Quelle boisson gazeuse me 	procurerait	 la plus grande quantité de caféine ? 
FQB_TREC-fr-760	Quel terme 	signifie	 un groupe d'oies ? 
FQB_TREC-fr-767	Quel format vidéo 	offrait	 une alternative au vhs ? 
FQB_TREC-fr-769	Quel groupe ethnique a 	introduit	 l'idée du potlatch ? 
FQB_TREC-fr-771	Qui a 	développé	 le potlatch ? 
FQB_TREC-fr-774	L'aéroport Logan 	dessert	 quelle ville ? 
FQB_TREC-fr-779-imp		Nommez	 l'université dont Woodrow Wilson fut président. 
FQB_TREC-fr-780	Woodrow Wilson a 	assumé	 la présidence de quelle université ? 
FQB_TREC-fr-781	Que 	signifie	 l'acronyme "CPR" ? 
FQB_TREC-fr-782	Que 	représentent	 les lettres "CPR" ? 
FQB_TREC-fr-787	Qu'est-ce qui a 	causé	 la mort de Bob Marley ? 
FQB_TREC-fr-788	Qu'est-ce qui a 	tué	 Bob Marley ? 
FQB_TREC-fr-800	Quel monarque 	signa	 la Magna Carta ? 
FQB_TREC-fr-801	Quel roi 	signa	 la Magna Carta ? 
FQB_TREC-fr-802	Qui fut le roi forcé de 	signer	 la Magna Carta ? 
FQB_TREC-fr-803	Quel roi 	signa	 la Magna Carta ? 
FQB_TREC-fr-804	Qui fut le roi qui 	signa	 la Magna Carta ? 
FQB_TREC-fr-805	Où 	trouve	-t-on le corps calleux d'un individu ? 
FQB_TREC-fr-806	Quelle partie de votre corps 	renferme	 le corps calleux ? 
FQB_TREC-fr-808	Quel mot anglais 	a	 le plus de lettres ? 
FQB_TREC-fr-809	Quel mot anglais 	contient	 le plus de lettres ? 
FQB_TREC-fr-818	Quelle ville l'aéroport McCarren 	dessert	-il ? 
FQB_TREC-fr-823	Qui a 	inventé	 "Les Muppets" ? 
FQB_TREC-fr-826-imp		Nommez	 le créateur des "Muppets". 
FQB_TREC-fr-829	Le jour de la Bastille 	a	 lieu à quelle date ? 
FQB_TREC-fr-832-imp		Nommez	 l'équivalent islamique de la Croix-Rouge. 
FQB_TREC-fr-840	Quelle période de l'année 	compte	 le plus de vols aériens ? 
FQB_TREC-fr-841	À quelle période de l'année le vol aérien 	connaît	-il le plus d'achalandage ? 
FQB_TREC-fr-843-imp		Nommez	 un terrain de golf de Myrtle Beach. 
FQB_TREC-fr-846-imp		Nommez	 l'équipe de baseball de Pittsburg. 
FQB_TREC-fr-854	Comment 	écrit	-on l'abréviation de "Original Equipment Manufacturer" ? 
FQB_TREC-fr-856	Où peut-on 	trouver	 le collège Rider ? 
FQB_TREC-fr-860	Quel métier 	fait	 Nicolas Cage ? 
FQB_TREC-fr-863	Comment 	traduit	-on "caliente" en anglais ? 
FQB_TREC-fr-879	Comment 	surnomme	-t-on le Mississippi ? 
FQB_TREC-fr-884	Qui 	produisait	 l'automobile à moteur rotatif ? 
FQB_TREC-fr-887	Quelle compagnie 	produisait	 des véhicules à moteur rotatif ? 
FQB_TREC-fr-890-imp		Nommez	 la montage la plus élevée. 
FQB_TREC-fr-892	Qu'est-ce qui 	fait	 de Black Hills, au Dakota du Sud, une destination touristique ? 
FQB_TREC-fr-900	De quelle équipe de baseball George Bush a-t-il 	acheté	 de petites parts ? 
FQB_TREC-fr-904	Quelle ville a 	reçu	 l'Exposition universelle en 1900 ? 
FQB_TREC-fr-907	Qui fut le premier homme à 	traverser	 le Pacifique en vol ? 
FQB_TREC-fr-910	Quel métal 	a	 le plus haut niveau de fusion ? 
FQB_TREC-fr-911	Qui 	développa	 le vaccin contre la polio ? 
FQB_TREC-fr-919	Qui a 	développé	 l'ordinateur Macintosh ? 
FQB_TREC-fr-929	Quel âge 	avait	 Elvis Presley lorsqu'il est mort ? 
FQB_TREC-fr-933	Combien y 	a	-t-il de Grands Lacs ? 
FQB_TREC-fr-939	Comment 	nomme	-t-on un groupe de dindes ? 
FQB_TREC-fr-942	Combien de litres 	contient	 un gallon ? 
FQB_TREC-fr-945	Qui a 	découvert	 les rayons x ? 
FQB_TREC-fr-948	Que 	fait	-on avec des drapeaux usés ou désuets ? 
FQB_TREC-fr-957	Que 	mangent	 les chauves-souris ? 
FQB_TREC-fr-958	Dans quel État a 	eu	 lieu la bataille de Bighorn ? 
FQB_TREC-fr-960	Comment 	appelle	-t-on le nouveau-né d'un kangourou ? 
FQB_TREC-fr-963	Quel détroit 	sépare	 l'Amérique du Nord de l'Asie ? 
FQB_TREC-fr-965	Combien 	coûtait	 un billet pour le Titanic ? 
FQB_TREC-fr-967	Quel compositeur américain a 	écrit	 la musique de West Side Story ? 
FQB_TREC-fr-975	Quand a 	eu	 lieu la première transplantation d'un foie ? 
FQB_TREC-fr-984	Pendant quelle guerre le département du Trésor américain a-t-il 	émis	 pour la première fois des devises en papier aux États-Unis ? 
FQB_TREC-fr-993	Quelle équipe de la Ligue Majeure de baseball a 	remporté	 le plus de victoires d'affilé ? 
FQB_TREC-fr-995	Qui a 	inventé	 la calculatrice ? 
FQB_TREC-fr-996	Comment 	mesure	-t-on les tremblements de terre ? 
FQB_TREC-fr-1009	Qui a 	remporté	 le titre de Miss America en 1989 ? 
FQB_TREC-fr-1011	Quel minéral aide à 	prévenir	 l'ostéoporose ? 
FQB_TREC-fr-1017	Qui a 	découvert	 l'Amérique ? 
FQB_TREC-fr-1025	Qui est l'abolitionniste ayant 	mené	 un raid sur le traversier Harper en 1859 ? 
FQB_TREC-fr-1026	Que 	signifie	 la fréquence cardiaque cible ? 
FQB_TREC-fr-1031	Qui a 	écrit	 l'hymne Amazing Grace ? 
FQB_TREC-fr-1042	Que 	signifie	 "Phi bêta kappa" ? 
FQB_TREC-fr-1045	Qui a 	découvert	 le radium ? 
FQB_TREC-fr-1048	Quelle équipe de baseball fut la première à 	intégrer	 des numéros dans ses uniformes ? 
FQB_TREC-fr-1052	Pour 	peupler	 quelle colonie des condamnés britanniques furent-ils utilisés à la fin des années 1700 ? 
FQB_TREC-fr-1053	Quel État est le centre géographique des 48 États américains 	excluant	 l'Alaska et Hawaii ? 
FQB_TREC-fr-1058	Quel est un autre terme astronomique pour 	désigner	 les aurores boréales ? 
FQB_TREC-fr-1059	De quelle péninsule l'Espagne 	fait	-elle partie ? 
FQB_TREC-fr-1062	Quel État 	reçoit	 le moins de pluie par année ? 
FQB_TREC-fr-1063	Qui a 	fondé	 la Croix-Rouge américaine ? 
FQB_TREC-fr-1066	Quand 	a	 lieu le solstice d'été ? 
FQB_TREC-fr-1069	Quel État américain 	a	 pour devise "Live Free or Die" ? 
FQB_TREC-fr-1072	Quelles couleurs primaires doit-on mélanger pour 	obtenir	 l'orange ? 
FQB_TREC-fr-1072	Quelles couleurs primaires doit-on 	mélanger	 pour obtenir l'orange ? 
FQB_TREC-fr-1089	Quelle ville 	a	 le code postal 35824 ? 
FQB_TREC-fr-1091	Qui a 	inventé	 le jeu de cerceau appelé "hula hoop" ? 
FQB_TREC-fr-1094	Quel est le nom du satellite que l'Union soviétique 	envoya	 dans l'espace en 1957 ? 
FQB_TREC-fr-1096	Qui a 	inventé	 le "slinky" ? 
FQB_TREC-fr-1097	Comment nomme-t-on les animaux qui ne 	possèdent	 pas de colonne vertébrale ? 
FQB_TREC-fr-1097	Comment 	nomme	-t-on les animaux qui ne possèdent pas de colonne vertébrale ? 
FQB_TREC-fr-1102	Que 	fait	 un défibrillateur ? 
FQB_TREC-fr-1103	Quel effet 	ont	 les précipitations acides ? 
FQB_TREC-fr-1104	En quelle année les États-Unis ont-ils 	aboli	 la conscription ? 
FQB_TREC-fr-1112	Combien de livres y 	a	-t-il dans une tonne ? 
FQB_TREC-fr-1116	Que 	signifie	 "Sitting Shiva" ? 
FQB_TREC-fr-1121	Que 	fait	 votre rate ? 
FQB_TREC-fr-1123	Qui a 	inventé	 le téléphone ? 
FQB_TREC-fr-1124	En quelle année les États-Unis ont-ils 	acheté	 l'Alaska ? 
FQB_TREC-fr-1127	Combien de gallons d'eau y 	a	-t-il dans un pied cube ? 
FQB_TREC-fr-1142	Que 	font	 les météorologistes ? 
FQB_TREC-fr-1143	Quels est le critère pour être légalement 	considéré	 aveugle ? 
FQB_TREC-fr-1146	Qu'est-ce qu'Edward Binney et Howard Smith on 	inventé	 en 1903 ? 
FQB_TREC-fr-1151	Comment 	appelle	-t-on la tenue multicolore traditionnelle de la Corée ? 
FQB_TREC-fr-1153	Combien 	valent	 les pesos mexicains en dollars américains ? 
FQB_TREC-fr-1156	Combien d'amiraux 	compte	 la Marine américaine ? 
FQB_TREC-fr-1158	Quelle âge 	avait	 Jeanne d'Arc à sa mort ? 
FQB_TREC-fr-1159	Que 	signifie	 le mot "quinzaine" ? 
FQB_TREC-fr-1174	Sur quelle partie du corps 	porte	-on un bonnet ? 
FQB_TREC-fr-1176	Que 	signifient	 I.V. ? 
FQB_TREC-fr-1187	Comment 	appelle	-t-on un dessinateur de carte géographique professionnel ? 
FQB_TREC-fr-1191	Quel âge doit-on avoir pour pouvoir 	louer	 une voiture en Italie ? 
FQB_TREC-fr-1191	Quel âge doit-on 	avoir	 pour pouvoir louer une voiture en Italie ? 
FQB_TREC-fr-1192	Que 	mesure	 un baromètre ? 
FQB_TREC-fr-1194	Que 	signifient	 les lettres "USPS" ? 
FQB_TREC-fr-1195	En quelle année la lnf a-t-elle 	fait	 la grève ? 
FQB_TREC-fr-1201	De toutes les planètes, quelle est celle 	ayant	 le champ magnétique le plus puissant ? 
FQB_TREC-fr-1203	En quelle année Mussolini a-t-il 	pris	 le pouvoir en Italie ? 
FQB_TREC-fr-1206	Combien de coeurs une pieuvre 	a	-t-elle ? 
FQB_TREC-fr-1219	Que 	signifie	 le terme technique "ISDN" ? 
FQB_TREC-fr-1226	Comment 	nomme	-t-on un groupe de grenouilles ? 
FQB_TREC-fr-1234	Combien 	pèse	 l'eau ? 
FQB_TREC-fr-1237	Quel est le seul président à avoir 	rempli	 deux mandats non-consécutifs ? 
FQB_TREC-fr-1239	Qui a 	peint	 le plafond de la chapelle Sixtine ? 
FQB_TREC-fr-1240-imp		Nommez	 un stimulant. 
FQB_TREC-fr-1249	Qui a 	écrit	 "The Devine Comedy" ? 
FQB_TREC-fr-1252	Pourquoi 	appelle	-t-on "love" un score nul au tennis ? 
FQB_TREC-fr-1255	Que 	signifie	 "ciao" ? 
FQB_TREC-fr-1256	Quelle est la seule artère qui 	transmet	 le sang veineux du coeur aux poumons ? 
FQB_TREC-fr-1257	À quelle fréquence l'Old Faithful du Parc national de Yellowstone 	fait	-il éruption ? 
FQB_TREC-fr-1268-imp		Nommez	 un aliment riche en zinc. 
FQB_TREC-fr-1272	Que 	signifie	 les lettres "CPR" ? 
FQB_TREC-fr-1274	Qui a 	tué	 John F. Kennedy ? 
FQB_TREC-fr-1278	Quel âge 	avait	 le plus jeune président des États-Unis ? 
FQB_TREC-fr-1284	Qui a 	inventé	 la caméra instantanée Polaroid ? 
FQB_TREC-fr-1286	Comment 	appelle	-t-on le bébé lion ? 
FQB_TREC-fr-1292	Les pays en développement 	comprennent	 quel pourcentage de la population mondiale ? 
FQB_TREC-fr-1297	Que 	signifie	 l'acronyme "NASA" ? 
FQB_TREC-fr-1302	En quelle année 	eut	 lieu le Boston Tea Party ? 
FQB_TREC-fr-1307	Que 	signifie	 "NASA" ? 
FQB_TREC-fr-1314	Quand a 	eu	 lieu la première transplantation d'un rein ? 
FQB_TREC-fr-1316	Quel était le nom de l'avion avec lequel Lindbergh 	traversa	 l'Atlantique en solitaire ? 
FQB_TREC-fr-1323	Qui a 	découvert	 l'oxygène ? 
FQB_TREC-fr-1327	Qui fut la première personne à 	atteindre	 le Pôle Nord ? 
FQB_TREC-fr-1332	Que 	signifie	 l'abréviation "sos" ? 
FQB_TREC-fr-1334	Qui a 	inventé	 Trivial Pursuit ? 
FQB_TREC-fr-1336	Quel pays 	a	 le plus de pollution de l'eau ? 
FQB_TREC-fr-1339	Quel race de chien de chasse 	avaient	 les Hillbillies de Beverley ? 
FQB_TREC-fr-1341	Qui fut le premier Afro-américain à 	remporter	 le prix Nobel de littérature ? 
FQB_TREC-fr-1342	Quand 	célèbre	-t-on la Saint-Patrick ? 
FQB_TREC-fr-1344	Quelles couleurs doit-on mélanger pour 	obtenir	 la couleur rose ? 
FQB_TREC-fr-1344	Quelles couleurs doit-on 	mélanger	 pour obtenir la couleur rose ? 
FQB_TREC-fr-1354	Qu'est-ce que Jesse Jackson a 	organisé	 ? 
FQB_TREC-fr-1358	Dans quel État 	trouve	-t-on les montagnes Catskill ? 
FQB_TREC-fr-1359	Comment 	appelle	-t-on un mot qui s'épelle de la même façon à l'envers qu'à l'endroit ? 
FQB_TREC-fr-1361	Quelle chaîne de magasin 	a	 son siège social à Bentonville, en Arkansas ? 
FQB_TREC-fr-1366	Quelle devise monétaire le Luxembourg 	utilise	-t-il ? 
FQB_TREC-fr-1369	Quelle devise monétaire l'Argentine 	utilise	-t-elle ? 
FQB_TREC-fr-1373	Quel pays a 	fait	 don de la statue de la Liberté aux États-Unis ? 
FQB_TREC-fr-1378	Quel fleuve 	traverse	 Rovigo, en Italie ? 
FQB_TREC-fr-1383	Dans quel astronef l'astronaute Alan Shepard a-t-il 	effectué	 son vol historique en 1961 ? 
FQB_TREC-fr-1386	Quelle est la façon la plus facile d'	enlever	 le papier-peint ? 
FQB_TREC-fr-1387	En quelle année le Titanic a-t-il 	commencé	 son voyage ? 
FQB_TREC-fr-1391	Combien de pieds 	composent	 un mille ? 
FQB_TREC-fr-1396	Quel est le nom du volcan qui a 	détruit	 la ville ancienne de Pompéi ? 
FQB_TREC-fr-1397	Quelle est la foule la plus nombreuse qui soit jamais allée 	voir	 Michael Jordan ? 
FQB_TREC-fr-1402	En quelle année Wilt Chamberlain a-t-il 	marqué	 100 points ? 
FQB_TREC-fr-1404	Combien de chromosomes 	compte	 un zygote humain ? 
FQB_TREC-fr-1405	Combien d'onces y 	a	-t-il dans un gallon ? 
FQB_TREC-fr-1407	Quand 	eut	 lieu la fusillade de Columbine ? 
FQB_TREC-fr-1410	Qu'est-ce qui 	pond	 des oeufs bleus ? 
FQB_TREC-fr-1411	Quel explorateur espagnol a 	découvert	 le fleuve Mississippi ? 
FQB_TREC-fr-1417	Qui fut la première personne à 	courir	 le mile en moins de quatre minutes ? 
FQB_TREC-fr-1421	Quand Mike Tyson a-t-il 	mordu	 l'oreille de Holyfield ? 
FQB_TREC-fr-1423-imp		Nommez	 une péninsule des Philippines. 
FQB_TREC-fr-1424	Qui a 	remporté	 l'Oscar du meilleur acteur en 1970 ? 
FQB_TREC-fr-1428	Qui a 	gagné	 le prix Nobel de la paix en 1992 ? 
FQB_TREC-fr-1430	Quel âge devez-vous 	avoir	 pour vous marier en Caroline du Sud ? 
FQB_TREC-fr-1431	Qui a 	tenu	 un rôle dans The Poseidon Adventure ? 
FQB_TREC-fr-1437	Combien d'États étaient toujours unis après que les États du Sud aient 	fait	 sécession ? 
FQB_TREC-fr-1449	Quel collège Magic Johnson a-t-il 	fréquenté	 ? 
FQB_TREC-fr-1454	Combien d'argent la Cour suprême des États-Unis 	fait	-elle ? 
FQB_TREC-fr-1455	Dans quelle ville du New Jersey 	eut	 lieu la catastrophe Hindenberg, en 1937 ? 
FQB_TREC-fr-1459-imp		Nommez	 un parc national de l'Indiana. 
FQB_TREC-fr-1465	Quelle compagnie 	fabrique	 les voitures Bentley ? 
FQB_TREC-fr-1469	Quand Alexandre Graham Bell a-t-il 	inventé	 le téléphone ? 
FQB_TREC-fr-1472	Comment 	dit	-on "maison" en espagnol ? 
FQB_TREC-fr-1475	Qui fut la première personne à 	atteindre	 le Pôle Sud ? 
FQB_TREC-fr-1479	Qui a 	composé	 "The Messiah" ? 
FQB_TREC-fr-1484	Quel collège Allen Iverson a-t-il 	fréquenté	 ? 
FQB_TREC-fr-1485	Quel est le nom d'argot pour 	désigner	 un billet de cinq dollars ? 
FQB_TREC-fr-1487	Combien 	coûtent	 les billets pour Disney World ? 
FQB_TREC-fr-1492	Quel âge avait Nolan Ryan lorsqu'il 	prit	 sa retraite ? 
FQB_TREC-fr-1492	Quel âge 	avait	 Nolan Ryan lorsqu'il prit sa retraite ? 
FQB_TREC-fr-1494	Qui a 	écrit	 "East is east, west is west and never the twain shall meet" ? 
FQB_TREC-fr-1498	Quelle école Emmit Smith a-t-il 	fréquentée	 ? 
FQB_TREC-fr-1499	Quel pays africain 	a	 pour principale exportation principale le café ? 
FQB_TREC-fr-1511	Qui a 	dit	 : "Music hath charm to soothe the savage beast" ? 
FQB_TREC-fr-1516	Que 	signifie	 les lettres "CPR" ? 
FQB_TREC-fr-1521	En quelle année l'île Ellis a-t-elle 	ouvert	 ses portes aux immigrants ? 
FQB_TREC-fr-1522	Comment nomme-t-on le couvre-chef que 	portent	 les Saoudiens ? 
FQB_TREC-fr-1522	Comment 	nomme	-t-on le couvre-chef que portent les Saoudiens ? 
FQB_TREC-fr-1531	Que 	signifie	 "NASDAQ" ? 
FQB_TREC-fr-1533	Qui a 	réalisé	 le film "Fail Safe" ? 
FQB_TREC-fr-1535	Qui a 	peint	 "Sunflowers" ? 
FQB_TREC-fr-1545	Comment 	appelle	-t-on la femelle du lapin ? 
FQB_TREC-fr-1551	Que 	signifie	 "ADN" ? 
FQB_TREC-fr-1552	Qu'a 	inventé	 Charles Babbage ? 
FQB_TREC-fr-1553	Qui 	fabrique	 les réfrigérateurs Magic Chef ? 
FQB_TREC-fr-1555	Quand 	eut	 lieu l'offensive du Têt au Viêtnam ? 
FQB_TREC-fr-1558	Combien 	coûte	 l'enregistrement d'une voiture au New Hampshire ? 
FQB_TREC-fr-1559	Où à Washington le Dr King a-t-il 	prononcé	 son discours ? 
FQB_TREC-fr-1568	Quel âge 	avait	 George Washington à sa mort ? 
FQB_TREC-fr-1569	Quand la Guerre du Viêtnam a-t-elle 	pris	 fin ? 
FQB_TREC-fr-1571	Combien de cuivre y 	a	-t-il dans une pièce d'un cent ? 
FQB_TREC-fr-1579	Quel pays 	exporte	 le plus de thé ? 
FQB_TREC-fr-1580	Quel nom donne-t-on à la science qui consiste à 	dessiner	 des cartes ? 
FQB_TREC-fr-1580	Quel nom 	donne	-t-on à la science qui consiste à dessiner des cartes ? 
FQB_TREC-fr-1581	Quel anniversaire 	célèbre	-t-on après 20 ans ? 
FQB_TREC-fr-1583	Comment 	appelle	-t-on le texte d'un opéra ? 
FQB_TREC-fr-1587	Comment Sherlock Holmes appelait-il le gang de rue qui l'aidait à 	mener	 des enquêtes ? 
FQB_TREC-fr-1587	Comment Sherlock Holmes appelait-il le gang de rue qui l'	aidait	 à mener des enquêtes ? 
FQB_TREC-fr-1587	Comment Sherlock Holmes 	appelait	-il le gang de rue qui l'aidait à mener des enquêtes ? 
FQB_TREC-fr-1589	Quel est le seul golfeur à avoir 	remporté	 les Opens et les Amateurs des États-Unis et de la Grande-Bretagne en une même année ? 
FQB_TREC-fr-1595	Quelle personne a 	développé	 le Cobol ? 
FQB_TREC-fr-1598	Quel joueur de baseball 	avait	 pour surnom "Mr. October" ? 
FQB_TREC-fr-1600	Quelle fabricant automobile 	fabrique	 la Spider ? 
FQB_TREC-fr-1602	Qui 	détient	 le record de l'artiste enfant le mieux payé ? 
FQB_TREC-fr-1604	Que 	signifie	 "R & B" ? 
FQB_TREC-fr-1605	Quelle distance 	coureriez	-vous si vous participiez à un marathon ? 
FQB_TREC-fr-1610	Qui a 	signé	 la Déclaration d'indépendance au Vermont ? 
FQB_TREC-fr-1612	Quand 	eut	 lieu l'invasion américaine d'Haïti ? 
FQB_TREC-fr-1617	Quand 	eut	 lieu la ruée vers l'or du Klondike ? 
FQB_TREC-fr-1619	Quel joueur vedette du baseball a 	volé	 130 buts en 1982 ? 
FQB_TREC-fr-1620	En quelle année 	eut	 lieu la première parade de l'Action de Grâce de Macy 's ? 
FQB_TREC-fr-1632	Combien de protéines y 	a	-t-il dans le tofu ? 
FQB_TREC-fr-1635	Quel est le nom de la célèbre course de traîneaux à chien qui 	a	 lieu annuellement en Alaska ? 
FQB_TREC-fr-1638	Quelle ville de l'Australie 	possède	 des forêts tropicales ? 
FQB_TREC-fr-1640	Qui a 	fondé	 le taoïsme ? 
FQB_TREC-fr-1641	D'où 'N Sync ont-ils 	pris	 leur nom ? 
FQB_TREC-fr-1642	Comment 	appelle	-t-on le bébé du paresseux ? 
FQB_TREC-fr-1643	Qui a 	fondé	 le Rhode Island ? 
FQB_TREC-fr-1645	Combien la Station spatiale internationale devrait-elle 	coûter	 ? 
FQB_TREC-fr-1648	Que 	signifie	 "TB" dans les statistiques au baseball ? 
FQB_TREC-fr-1653	Comment 	dit	-on "French fries" en français ? 
FQB_TREC-fr-1657	Comment les Français 	appellent	-ils le "English Channel" ? 
FQB_TREC-fr-1661	Que 	signifie	 "E pluribus unum" ? 
FQB_TREC-fr-1663	Comment nomme-t-on les personnes qui 	fabriquent	 des feux d'artifices ? 
FQB_TREC-fr-1663	Comment 	nomme	-t-on les personnes qui fabriquent des feux d'artifices ? 
FQB_TREC-fr-1664	Qui fut la première personne à 	fabriquer	 un hélicoptère ? 
FQB_TREC-fr-1675	Quel groupe a 	chanté	 la chanson "Happy Together" ? 
FQB_TREC-fr-1676	Quand a-t-on 	trouvé	 de l'eau sur Mars ? 
FQB_TREC-fr-1684	Quel jeu de cartes n'	utilise	 que 48 cartes ? 
FQB_TREC-fr-1686	Qui a 	défait	 l'Armada espagnole ? 
FQB_TREC-fr-1687	Quel président a 	institué	 la Fête des Mères ? 
FQB_TREC-fr-1689	À quelle guerre 	fait	 référence le livre "Charge of the Light Brigade" ? 
FQB_TREC-fr-1690	Que 	signifie	 "DEA" ? 
FQB_TREC-fr-1702	Quelle compagnie 	a	 pour slogan "Quality is job 1" ? 
FQB_TREC-fr-1703	Quel prix a 	mérité	 en 1963 le livre Rascal de Sterling North ? 
FQB_TREC-fr-1708	Quand 	eut	 lieu le déversement de l'Exxon Valdez ? 
FQB_TREC-fr-1712	Qui a 	inventé	 le moulinet de canne à pêche ? 
FQB_TREC-fr-1715	Quelle quantité de vitamine C devrait-on 	prendre	 quotidiennement ? 
FQB_TREC-fr-1716	Qui fut le premier à 	remporter	 le Triple Crown ? 
FQB_TREC-fr-1717	Quelle ville fut la première au monde à 	atteindre	 une population de plus d'un million d'habitants ? 
FQB_TREC-fr-1719	Quelle est la distance qui 	sépare	 Jupiter du Soleil ? 
FQB_TREC-fr-1724-imp		Nommez	 un dieu égyptien. 
FQB_TREC-fr-1725	Où David Ogden Stiers a-t-il 	obtenu	 son diplôme de premier cycle ? 
FQB_TREC-fr-1727	Que 	signifie	 l'abréviation "WASP" ? 
FQB_TREC-fr-1728	Quand le stade Yankee a-t-il 	ouvert	 ses portes ? 
FQB_TREC-fr-1734	Comment 	dit	-on "cochon" en espagnol ? 
FQB_TREC-fr-1736	Où sur le corps 	trouve	-t-on les joues ? 
FQB_TREC-fr-1737	Quelle quantité de sommeil un enfant devrait-il 	avoir	 la nuit ? 
FQB_TREC-fr-1742	Quand la période mésozoïque a-t-elle 	pris	 fin ? 
FQB_TREC-fr-1743	Quel État 	a	 la plus longue côte maritime sur l'océan Atlantique ? 
FQB_TREC-fr-1744	Quelle fabricant automobile a 	inventé	 l'Edsel ? 
FQB_TREC-fr-1745	Qu'est-ce qui 	cause	 le hoquet ? 
FQB_TREC-fr-1746	Qui a 	poignardé	 Monica Seles ? 
FQB_TREC-fr-1748	Quand 	eurent	 lieu les émeutes de Los Angeles ? 
FQB_TREC-fr-1752	Quand 	eut	 lieu l'attentat d'Oklahoma City ? 
FQB_TREC-fr-1757	Quand la bataille d'Iwo Jima a-t-elle 	eu	 lieu ? 
FQB_TREC-fr-1759	Qui a 	écrit	 "Fiddler on the Roof" ? 
FQB_TREC-fr-1761	Combien y 	a	-t-il de notes noires sur un piano ? 
FQB_TREC-fr-1764	Quel dictateur cubain Fidel Castro a-t-il 	renversé	 en 1958 ? 
FQB_TREC-fr-1765	Quel aéroport 	porte	 les initiales LCY ? 
FQB_TREC-fr-1772	Qui a 	inventé	 le jean de coton ? 
FQB_TREC-fr-1774	Que 	signifie	 "HTML" ? 
FQB_TREC-fr-1775	Comment 	appelle	-t-on un groupe d'antilopes ? 
FQB_TREC-fr-1777	Quel personnage Scott Bakula a-t-il 	joué	 dans American Beauty ? 
FQB_TREC-fr-1780	Qui 	a	 le plus de prises au baseball de la ligue majeure ? 
FQB_TREC-fr-1786	Quel est le plus haut nombre de points que Michael Jordan ait 	marqués	 en une seule partie ? 
FQB_TREC-fr-1788	Qui 	fabrique	 le Viagra ? 
FQB_TREC-fr-1795	À quelle distance un pointeur laser 	émet	-il ses rayons ? 
FQB_TREC-fr-1796	En quelle année le Général Montgomery a-t-il 	mené	 les Alliés à une victoire sur les troupes de l'Axe en Afrique du Nord ? 
FQB_TREC-fr-1803	Quand Willis Haviland Carrier a-t-il 	construit	 le climatiseur ? 
FQB_TREC-fr-1804	Quel fleuve 	traverse	 Dublin ? 
FQB_TREC-fr-1806	Quand 	eut	 lieu la première transplantation cardiaque ? 
FQB_TREC-fr-1807	Combien de passagers un avion de type Boeing 747 peut-il 	transporter	 ? 
FQB_TREC-fr-1808	Quelle île les États-Unis ont-ils 	gagnée	 après la Guerre américano-espagnole ? 
FQB_TREC-fr-1816	Quel âge faut-il 	avoir	 pour devenir président des États-Unis ? 
FQB_TREC-fr-1821	Qui étaient les architectes ayant 	fait	 les plans du Empire State Building ? 
FQB_TREC-fr-1823	Michael Jordan 	portait	 quel numéro ? 
FQB_TREC-fr-1824	Le vaisseau Magellan a permis aux scientifiques de 	faire	 des recherches approfondies sur quelle planète ? 
FQB_TREC-fr-1826	Quel film a 	reçu	 le premier Oscar du meilleur film ? 
FQB_TREC-fr-1832	Que 	disait	 Walter Cronkite à la fin de chaque émission ? 
FQB_TREC-fr-1834	Quel disciple a reçu 30 pièces d'argent pour avoir 	trahi	 Jésus ? 
FQB_TREC-fr-1834	Quel disciple a 	reçu	 30 pièces d'argent pour avoir trahi Jésus ? 
FQB_TREC-fr-1836	Quel fleuve 	traverse	 Rome, en Italie ? 
FQB_TREC-fr-1842	Combien 	coûtait	 une pinte de lait dans les années 1930 ? 
FQB_TREC-fr-1844	Quand 	eut	 lieu l'ère hellénistique ? 
FQB_TREC-fr-1848	Quel était le nom de l'avion ayant 	largué	 la bombe nucléaire sur Hiroshima ? 
FQB_TREC-fr-1851	Quel pays a 	colonisé	 Hong Kong ? 
FQB_TREC-fr-1854	Quelle était la profession de William Shakespeare avant que il ne commence à 	composer	 des pièces de théâtre ? 
FQB_TREC-fr-1859	Quel service des Forces armées 	a	 son académie à Annapolis ? 
FQB_TREC-fr-1863	Qui a 	dit	 : "I have not begun to fight !" ? 
FQB_TREC-fr-1871	Quelle gravité y 	a	-t-il sur Mars ? 
FQB_TREC-fr-1874	Quand 	eut	 lieu la bataille de Shiloh ? 
FQB_TREC-fr-1885	Quelle langue 	parle	-t-on en Nouvelle-Calédonie ? 
FQB_TREC-fr-1889	Quel âge 	a	 la Pyramide rouge ? 
FQB_UNESCO-2	Que cela 	signifie	-t-il pour un bien d'être inscrit sur la Liste ? 
FQB_UNESCO-6	Comment 	inscrit	-on un bien sur la Liste ? 
FQB_UNESCO-7	Qui 	inscrit	 les biens ? 
FQB_UNESCO-9	à qui puis-je 	adresser	 une suggestion ? 
FQB_UNESCO-10	Qui puis-je 	informer	 d'une menace pesant sur un bien du patrimoine mondial ou un bien sur la Liste du patrimoine mondial en péril ? 
FQB_UNESCO-13	Quelles universités 	proposent	 des programmes relatifs au patrimoine mondial ? 
FQB_UNESCO-15	Comment puis-je 	obtenir	/utiliser les photos de sites du patrimoine mondial ? 
FQB_UNESCO-16	Je suis photographe, comment puis-je proposer mes services ou 	vendre	 mes photos à l'UNESCO ? 
FQB_UNESCO-16	Je suis photographe, comment puis-je 	proposer	 mes services ou vendre mes photos à l'UNESCO ? 
FQB_UNESCO-17		Existe	-t-il des publications ou des brochures gratuites sur le patrimoine mondial ? 
FQB_UNESCO-18	Comment m'	abonner	 à la Revue du patrimoine mondial ? 
FQB_UNESCO-19	Comment 	commander	 le calendrier/agenda de bureau du Centre du patrimoine mondial ? 
FQB_UNESCO-20	Puis-je 	utiliser	 le logo du patrimoine mondial dans des brochures, publicités ou d'autres média ? 
FQB_UNESCO-24	Comment travailler/	faire	 un stage au Centre du patrimoine mondial de l'UNESCO ? 
FQB_UNESCO-25	Comment 	faire	 du bénévolat sur un site du patrimoine mondial ? 
