sent_id	left_context	pivot	right_context
fr_partut-ud-3	La distribution de la présente version de ce contrat ne crée aucune relation juridique entre les parties au contrat 	présenté	 ci-après et Creative Commons. 
fr_partut-ud-5	Creative Commons ne saurait être tenu responsable des éventuels préjudices résultant du 	contenu	 ou de l'utilisation de ce contrat. 
fr_partut-ud-11	Selon les termes et les obligations du présent contrat, la partie offrante propose à la partie acceptante l'exercice de certains droits 	présentés	 ci-après, et l'acceptant en approuve les termes et conditions d'utilisation. 
fr_partut-ud-13	Aux termes de la présente autorisation, une oeuvre qui constitue une Oeuvre dite collective ne sera pas considérée comme une oeuvre dite derivée (telle que 	définie	 ci-après). 
fr_partut-ud-19	reproduire l'Oeuvre, incorporer l'Oeuvre dans une ou plusieurs oeuvres dites derivées et reproduire l'oeuvre telle qu'incorporée dans les 	dites	 oeuvres dites collectives; 
fr_partut-ud-20	créer et 	reproduire	 des oeuvres dites derivées; 
fr_partut-ud-21	distribuer des exemplaires ou enregistrements, présenter, représenter ou communiquer l'oeuvre au public par tout procédé technique, y 	compris	 incorporée dans des oeuvres collectives; 
fr_partut-ud-21	distribuer des exemplaires ou enregistrements, présenter, 	représenter	 ou communiquer l'oeuvre au public par tout procédé technique, y compris incorporée dans des oeuvres collectives; 
fr_partut-ud-21	distribuer des exemplaires ou enregistrements, 	présenter	, représenter ou communiquer l'oeuvre au public par tout procédé technique, y compris incorporée dans des oeuvres collectives; 
fr_partut-ud-22	Distribuer des exemplaires ou phonogrammes, présenter, 	représenter	 ou communiquer au public des oeuvres dites derivées par tout procédé technique; 
fr_partut-ud-22	Distribuer des exemplaires ou phonogrammes, 	présenter	, représenter ou communiquer au public des oeuvres dites derivées par tout procédé technique; 
fr_partut-ud-23	lorsque l'Oeuvre est une base de données, 	extraire	 et réutiliser des parties substantielles de l'oeuvre. 
fr_partut-ud-24	Les droits 	mentionnés	 ci-dessus peuvent être exercés sur tous les supports, médias, procédés techniques et formats. 
fr_partut-ud-28	L'autorisation accordée par l'article 3 est expressément 	assujettie	 et limitée par le respect des restrictions suivantes: 
fr_partut-ud-29	l'Acceptant ne peut pas offrir ou imposer de conditions d'utilisation de l'oeuvre qui 	altèrent	 ou restreignent les termes du présent contrat ou l'exercice des droits qui y sont accordés au bénéficiaire. 
fr_partut-ud-29	l'Acceptant ne peut pas 	offrir	 ou imposer de conditions d'utilisation de l'oeuvre qui altèrent ou restreignent les termes du présent contrat ou l'exercice des droits qui y sont accordés au bénéficiaire. 
fr_partut-ud-32	L'acceptant ne peut pas reproduire, distribuer, représenter ou communiquer au public l'oeuvre, y 	compris	 par voie numérique, en utilisant une mesure technique de contrôle d'accès ou de contrôle d'utilisation qui serait contradictoire avec les termes de cet accord contractuel. 
fr_partut-ud-32	L'acceptant ne peut pas reproduire, distribuer, 	représenter	 ou communiquer au public l'oeuvre, y compris par voie numérique, en utilisant une mesure technique de contrôle d'accès ou de contrôle d'utilisation qui serait contradictoire avec les termes de cet accord contractuel. 
fr_partut-ud-32	L'acceptant ne peut pas reproduire, 	distribuer	, représenter ou communiquer au public l'oeuvre, y compris par voie numérique, en utilisant une mesure technique de contrôle d'accès ou de contrôle d'utilisation qui serait contradictoire avec les termes de cet accord contractuel. 
fr_partut-ud-34	Si l'acceptant crée une oeuvre dite collective, à la demande de tout offrant, il devra, dans la mesure du possible, retirer de l'oeuvre dite collective toute référence au dit offrant, comme 	demandé	. 
fr_partut-ud-34	Si l'acceptant crée une oeuvre dite collective, à la demande de tout offrant, il devra, dans la mesure du possible, retirer de l'oeuvre dite collective toute référence au 	dit	 offrant, comme demandé. 
fr_partut-ud-35	Si l'acceptant crée une oeuvre dite dérivée, à la demande de tout offrant, il devra, dans la mesure du possible, retirer de l'oeuvre dite dérivée toute référence au dit offrant, comme 	demandé	. 
fr_partut-ud-35	Si l'acceptant crée une oeuvre dite dérivée, à la demande de tout offrant, il devra, dans la mesure du possible, retirer de l'oeuvre dite dérivée toute référence au 	dit	 offrant, comme demandé. 
fr_partut-ud-36	L'acceptant peut reproduire, distribuer, représenter ou communiquer au public une oeuvre dite dérivée y 	compris	 par voie numérique uniquement sous les termes de ce contrat, ou d'une version ultérieure de ce contrat comprenant les mêmes options du contrat que le présent contrat, ou un contrat Creative Commons Icommons comprenant les mêmes options du contrat que le présent contrat (par exemple paternité-pas d'utilisation commerciale-Partage des conditions initiales à l'Identique 2.0 Japon). 
fr_partut-ud-36	L'acceptant peut reproduire, distribuer, représenter ou 	communiquer	 au public une oeuvre dite dérivée y compris par voie numérique uniquement sous les termes de ce contrat, ou d'une version ultérieure de ce contrat comprenant les mêmes options du contrat que le présent contrat, ou un contrat Creative Commons Icommons comprenant les mêmes options du contrat que le présent contrat (par exemple paternité-pas d'utilisation commerciale-Partage des conditions initiales à l'Identique 2.0 Japon). 
fr_partut-ud-36	L'acceptant peut reproduire, distribuer, 	représenter	 ou communiquer au public une oeuvre dite dérivée y compris par voie numérique uniquement sous les termes de ce contrat, ou d'une version ultérieure de ce contrat comprenant les mêmes options du contrat que le présent contrat, ou un contrat Creative Commons Icommons comprenant les mêmes options du contrat que le présent contrat (par exemple paternité-pas d'utilisation commerciale-Partage des conditions initiales à l'Identique 2.0 Japon). 
fr_partut-ud-36	L'acceptant peut reproduire, 	distribuer	, représenter ou communiquer au public une oeuvre dite dérivée y compris par voie numérique uniquement sous les termes de ce contrat, ou d'une version ultérieure de ce contrat comprenant les mêmes options du contrat que le présent contrat, ou un contrat Creative Commons Icommons comprenant les mêmes options du contrat que le présent contrat (par exemple paternité-pas d'utilisation commerciale-Partage des conditions initiales à l'Identique 2.0 Japon). 
fr_partut-ud-37	l'Acceptant ne peut pas offrir ou imposer de conditions d'utilisation sur l'oeuvre dite dérivée qui 	altèrent	 ou restreignent les termes du présent contrat ou l'exercice des droits qui y sont accordés au bénéficiaire, et doit conserver intactes toutes les informations qui renvoient à ce contrat et à l'avertissement sur les garanties. 
fr_partut-ud-37	l'Acceptant ne peut pas 	offrir	 ou imposer de conditions d'utilisation sur l'oeuvre dite dérivée qui altèrent ou restreignent les termes du présent contrat ou l'exercice des droits qui y sont accordés au bénéficiaire, et doit conserver intactes toutes les informations qui renvoient à ce contrat et à l'avertissement sur les garanties. 
fr_partut-ud-38	L'acceptant ne peut pas reproduire, distribuer, représenter ou communiquer au public y 	compris	 par voie numérique l'oeuvre dite dérivée en utilisant une mesure technique de contrôle d'accès ou de contrôle d'utilisation qui serait contradictoire avec les termes de cet accord contractuel. 
fr_partut-ud-38	L'acceptant ne peut pas reproduire, distribuer, représenter ou 	communiquer	 au public y compris par voie numérique l'oeuvre dite dérivée en utilisant une mesure technique de contrôle d'accès ou de contrôle d'utilisation qui serait contradictoire avec les termes de cet accord contractuel. 
fr_partut-ud-38	L'acceptant ne peut pas reproduire, distribuer, 	représenter	 ou communiquer au public y compris par voie numérique l'oeuvre dite dérivée en utilisant une mesure technique de contrôle d'accès ou de contrôle d'utilisation qui serait contradictoire avec les termes de cet accord contractuel. 
fr_partut-ud-38	L'acceptant ne peut pas reproduire, 	distribuer	, représenter ou communiquer au public y compris par voie numérique l'oeuvre dite dérivée en utilisant une mesure technique de contrôle d'accès ou de contrôle d'utilisation qui serait contradictoire avec les termes de cet accord contractuel. 
fr_partut-ud-40	le titre de l'oeuvre originale s'il est 	indiqué	; 
fr_partut-ud-41	Dans la mesure du possible, l'adresse Internet ou Identifiant Uniforme de Ressource (URI), s'il 	existe	, spécifié par l'offrant comme associé à l'oeuvre, à moins que cette adresse ne renvoie pas aux informations légales (paternité et conditions d'utilisation de l'oeuvre). 
fr_partut-ud-42	Dans le cas d'une oeuvre dite dérivée, il doit indiquer les éléments identifiant l'utilisation l'oeuvre dans l'oeuvre dite dérivée par exemple «traduction anglaise de l'oeuvre par l'auteur original» ou «Scénario 	basé	 sur l'oeuvre par l'auteur original». 
fr_partut-ud-48	À l'exception des garanties d'ordre public imposées par la loi applicable et des réparations imposées par le régime de la responsabilité vis-à-vis d'un tiers en raison de la violation des garanties prévues par l'article 5 du présent contrat, l'offrant ne sera en aucun cas tenu responsable vis-à-vis de l'acceptant, sur la base d'aucune théorie légale ni en raison de aucun préjudice direct, indirect, matériel ou moral, résultant de l'exécution du présent contrat ou de l'utilisation de l'oeuvre, y 	compris	 dans l'hypothèse où l'offrant avait connaissance de la possible existence d'un tel préjudice. 
fr_partut-ud-50	Tout manquement aux termes du contrat par l'acceptant entraîne la résiliation automatique du contrat et la fin des droits qui en 	découlent	. 
fr_partut-ud-53	Dans les limites 	indiquées	 ci-dessus, le présent contrat s'applique pendant toute la durée de protection de l'oeuvre selon le droit applicable. 
fr_partut-ud-55	cependant, le recours à cette option ne doit pas conduire à retirer les effets du présent contrat (ou de tout contrat qui a été ou doit être accordé selon les termes de ce contrat), et ce contrat continuera à s'appliquer dans tous ses effets jusqu'à ce que sa résiliation intervienne dans les conditions 	décrites	 ci-dessus. 
fr_partut-ud-61	Il n'existe aucun élément annexe, accord supplémentaire ou mandat portant sur cette oeuvre en dehors des éléments 	mentionnés	 ici. 
fr_partut-ud-65	Creative Commons décline toute responsabilité à l'égard de l'acceptant ou de toute autre partie, quel que soit le fondement légal de cette responsabilité et quel que soit le préjudice 	subi	, direct, indirect, matériel ou moral, qui surviendrait en rapport avec le présent contrat. 
fr_partut-ud-65	Creative Commons décline toute responsabilité à l'égard de l'acceptant ou de toute autre partie, quel que soit le fondement légal de cette responsabilité et quel que 	soit	 le préjudice subi, direct, indirect, matériel ou moral, qui surviendrait en rapport avec le présent contrat. 
fr_partut-ud-65	Creative Commons décline toute responsabilité à l'égard de l'acceptant ou de toute autre partie, quel que 	soit	 le fondement légal de cette responsabilité et quel que soit le préjudice subi, direct, indirect, matériel ou moral, qui surviendrait en rapport avec le présent contrat. 
fr_partut-ud-71	Je déclare 	reprise	 la session du Parlement européen qui avait été interrompue le vendredi 17 décembre dernier et je vous renouvelle tous mes voeux en espérant que vous avez passé de bonnes vacances. 
fr_partut-ud-73	En attendant, je souhaiterais, comme un certain nombre de collègues me l'ont demandé, que nous observions une minute de silence pour toutes les victimes, des tempêtes notamment, dans les différents pays de l'Union Européenne qui ont été 	touchés	. 
fr_partut-ud-73	En 	attendant	, je souhaiterais, comme un certain nombre de collègues me l'ont demandé, que nous observions une minute de silence pour toutes les victimes, des tempêtes notamment, dans les différents pays de l'Union Européenne qui ont été touchés. 
fr_partut-ud-78	L'une des personnes qui vient d'être assassinée au Sri Lanka est M. Kumar Ponnambalam, qui avait rendu visite au parlement européen il y 	a	 quelques mois à peine. 
fr_partut-ud-79	Ne pensez-vous pas, madame la présidente, qu'il 	conviendrait	 d'écrire une lettre au président du Sri Lanka pour lui communiquer que le parlement déplore les morts violentes, dont celle de M. Ponnambalam, et pour l'inviter instamment à faire tout ce qui est en son pouvoir pour chercher une réconciliation pacifique et mettre un terme à cette situation particulièrement difficile. 
fr_partut-ud-90	Cependant, je vous demande, conformément à l'orientation désormais constamment exprimée par le parlement européen et toute la communauté européenne, d'intervenir auprès du président et du gouverneur du Texas, monsieur Bush, en faisant 	jouer	 le prestige de votre mandat et de l'institution que vous représentez, car c'est monsieur Bush qui a le pouvoir de suspendre la condamnation à mort et de gracier le condamné. 
fr_partut-ud-96	Cependant, il se 	fait	 qu'il semblerait être à nouveau mis en accusation, le ministère public ayant interjeté appel. 
fr_partut-ud-97	Nous savons, et nous l'avons d'ailleurs établi dans de très nombreuses résolutions - y 	compris	 lors de la dernière période de session de l'année dernière -, que ce cas n'est pas seulement de nature juridique et qu'il est faux d'accuser Alexandre Nikitin d'activité criminelle et de trahison car nous sommes concernés par ses résultats et nous en profitons. 
fr_partut-ud-101	Toutefois, madame la présidente, ce que j'avais demandé n'a pas été 	réalisé	. 
fr_partut-ud-105	Madame la présidente, comment se 	fait	-il que le parlement ne se conforme pas à la réglementation en matière de santé et de sécurité qu'il vote? 
fr_partut-ud-106	Comment se 	fait	-il que aucun test de qualité de l'air n'ait été réalisé dans ce bâtiment depuis notre élection? 
fr_partut-ud-107	Comment se 	fait	-il que le comité de santé et d'hygiène ne se soit plus réuni depuis 1998? 
fr_partut-ud-108	Comment se 	fait	-il que nous n'ayons jamais fait d'exercice d'évacuation dans les bâtiments du parlement de Bruxelles et de Strasbourg? 
fr_partut-ud-109	Comment se 	fait	-il qu'il n'y ait pas de consignes en cas d'incendie? 
fr_partut-ud-110	Comment se 	fait	-il que les escaliers n'aient pas été améliorés depuis mon accident? 
fr_partut-ud-111	Comment se 	fait	-il qu'l'on ne respecte pas les zones non fumeurs? 
fr_partut-ud-112	Madame Lynne, vous avez parfaitement raison et je vais vérifier si tout cela n'a effectivement pas été 	fait	. 
fr_partut-ud-121	Madame la présidente, je voudrais savoir si cette semaine, le parlement va envoyer un message clair exprimant son mécontentement quant à la décision 	prise	 aujourd'hui de refuser de renouveler l'embargo sur les armes à destination de l'Indonésie, alors que par le passé, le parlement a souscrit à une très large majorité à l'embargo sur les armes à destination de l'Indonésie. 
fr_partut-ud-124	En 	refusant	 de prolonger l'embargo, les états membres font preuve d'irresponsabilité. 
fr_partut-ud-126	Nous ne savons pas ce qui se 	passe	. 
fr_partut-ud-132	Il s'est donc 	écoulé	 suffisamment de temps pour que la commission prépare son programme et pour que nous puissions en prendre connaissance et l'expliquer aux citoyens. 
fr_partut-ud-134	Les événements qui se sont produits la semaine dernière ­ qui sont nés en marge de la conférence des présidents et se servent d'elle dans le seul but de 	corroborer	 et de ratifier des décisions prises en dehors de celle-ci ­ créent un dilemme: 
fr_partut-ud-136	Mon groupe estimant qu'un parlement est là pour écouter, pour débattre et pour 	réfléchir	, nous pensons qu'aucune raison ne justifie cet ajournement et nous croyons que si la commission est en mesure de le présenter, nous avons parfaitement le temps pour rétablir l'accord original entre le parlement et la commission et d'agir de manière responsable vis-à-vis de nos concitoyennes et concitoyens. 
fr_partut-ud-136	Mon groupe estimant qu'un parlement est là pour écouter, pour 	débattre	 et pour réfléchir, nous pensons qu'aucune raison ne justifie cet ajournement et nous croyons que si la commission est en mesure de le présenter, nous avons parfaitement le temps pour rétablir l'accord original entre le parlement et la commission et d'agir de manière responsable vis-à-vis de nos concitoyennes et concitoyens. 
fr_partut-ud-136	Mon groupe estimant qu'un parlement est là pour 	écouter	, pour débattre et pour réfléchir, nous pensons qu'aucune raison ne justifie cet ajournement et nous croyons que si la commission est en mesure de le présenter, nous avons parfaitement le temps pour rétablir l'accord original entre le parlement et la commission et d'agir de manière responsable vis-à-vis de nos concitoyennes et concitoyens. 
fr_partut-ud-142	Des décisions 	existent	 qui s'opposent à une telle taxe. 
fr_partut-ud-147	Ce n'est pas 	demander	 beaucoup. 
fr_partut-ud-154	Les modifications n'ont pas lieu d'	être	. 
fr_partut-ud-160	Je le déplore mais le vote a été effectué, la décision est tombée et nous devrions donc en 	rester	 là. 
fr_partut-ud-160	Je le déplore mais le vote a été effectué, la décision est 	tombée	 et nous devrions donc en rester là. 
fr_partut-ud-160	Je le déplore mais le vote a été 	effectué	, la décision est tombée et nous devrions donc en rester là. 
fr_partut-ud-161	Cela 	étant	, je crois que les positions sont bien claires et elles seront consignées au procès-verbal. 
fr_partut-ud-162	Lorsque nous adopterons demain le procès-verbal de la séance d'aujourd'hui, les collègues qui estimeront que les positions n'ont pas été suffisamment bien 	expliquées	 pourront demander des modifications. 
fr_partut-ud-164	Bien 	entendu	, le procès-verbal de la réunion de demain tiendra compte de toutes les explications complémentaires. 
fr_partut-ud-167	Madame la présidente, si le procès-verbal reflète correctement le vote de mon groupe, je n'ai et n'aurai aucune objection à 	formuler	. 
fr_partut-ud-167	Madame la présidente, si le procès-verbal reflète correctement le vote de mon groupe, je n'	ai	 et n'aurai aucune objection à formuler. 
fr_partut-ud-170	(Le parlement adopte l'ordre des travaux ainsi 	modifié	). 
fr_partut-ud-171	Madame la présidente, nous ne pouvons pas - nous n'avons pas le droit - de nous résigner à entendre parler de plus en plus souvent d'accidents qui provoquent, sur les routes, les voies ferrées et navigables, des dégâts importants également imputables au fait que les personnes 	concernées	 ne prennent pas assez au sérieux le transport de marchandises dangereuses ou que par ignorance ou par manque de formation du chauffeur ou de la personne responsable des divers moyens de transport, il arrive trop souvent qu'un accident bénin tourne à la catastrophe. 
fr_partut-ud-171	Madame la présidente, nous ne 	pouvons	 pas - nous n'avons pas le droit - de nous résigner à entendre parler de plus en plus souvent d'accidents qui provoquent, sur les routes, les voies ferrées et navigables, des dégâts importants également imputables au fait que les personnes concernées ne prennent pas assez au sérieux le transport de marchandises dangereuses ou que par ignorance ou par manque de formation du chauffeur ou de la personne responsable des divers moyens de transport, il arrive trop souvent qu'un accident bénin tourne à la catastrophe. 
fr_partut-ud-176	Notre réponse à de telles catastrophes doit être la prévention et le projet de directive qui nous est soumis nous permet de créer une base importante en vue de disposer de responsables bien formés en matière de sécurité et, dans le même temps, de faire ce qui doit être 	fait	. 
fr_partut-ud-180	nous ne pouvons pas nous contenter de combler une des carences du réseau de sécurité et ignorer qu'en matière de sécurité des transports, il y a encore énormément à 	faire	. 
fr_partut-ud-187	En conséquence, mon groupe soutiendra la position commune et espère que la législation sera rapidement 	promulguée	, qui nous fournira un outil de plus dans notre lutte pour que le transport au sein de l'union atteigne le plus haut niveau de sécurité possible. 
fr_partut-ud-192	Il s'	agit	 de l'harmonisation des exigences des examens, mais également des exigences minimales. 
fr_partut-ud-196	En outre, une enquête menée dans des ports belges, finnois et japonais a révélé que 50 pour cent des conteneurs avec un chargement partiellement dangereux n'étaient pas correctement 	déchargés	. 
fr_partut-ud-202	Le travail est fait, il s'	agit	 encore d'en assurer le respect. 
fr_partut-ud-202	Le travail est 	fait	, il s'agit encore d'en assurer le respect. 
fr_partut-ud-211	Je suis ravi qu'il y ait également un accord avec le conseil concernant les normes minimales pour leurs examens, même si j'aurais préféré des normes fixes et 	uniformisées	, afin d'avoir des diplômes et des examens internationaux identiques. 
fr_partut-ud-212	Toutefois, cela ne 	paraît	 pas réalisable. 
fr_partut-ud-213	Pour conclure, l'amendement proposé par le rapporteur est on ne 	peut	 plus logique et je le soutiens avec joie. 
fr_partut-ud-213	Pour 	conclure	, l'amendement proposé par le rapporteur est on ne peut plus logique et je le soutiens avec joie. 
fr_partut-ud-217	Lorsque je considère que la première proposition de la commission a été déposée le 19 mars 1998 et que nous nous en occupons aujourd'hui - alors que le parlement a 	réagi	 assez rapidement - le délai est un peu trop long. 
fr_partut-ud-219	Le deuxième point a déjà été 	évoqué	: 
fr_partut-ud-230	Nous pensons que la collaboration, le travail commun de la part des deux institutions ­ parlement et commission ­ est importante et que la coopération qui 	existe	 avec la commission de la politique régionale, et concrètement avec le groupe des transports, est magnifique. 
fr_partut-ud-231	La position commune inclut pratiquement tous les amendements acceptés par la commission, harmonise les exigences minimales applicables aux examens des conseillers à la sécurité et, en deuxième lecture, nous pouvons accepter la date 	proposée	, bien plus réaliste que celle projetée au départ par la commission, sachant que cela fait déjà plusieurs années que nous débattons cette question. 
fr_partut-ud-233	Comme l'a très bien dit M. Simpson, il ne faut jamais considérer que le processus est acquis, qu'il a 	abouti	. 
fr_partut-ud-233	Comme l'a très bien dit M. Simpson, il ne faut jamais considérer que le processus est 	acquis	, qu'il a abouti. 
fr_partut-ud-234	Le processus visant à augmenter les marges, les garanties de sécurité dans les transports est un processus qu'il 	convient	 d'améliorer jour après jour. 
fr_partut-ud-236	Lors d'un des gros accidents survenus dernièrement, la marchandise 	transportée	 n'était pas dangereuse en soi. 
fr_partut-ud-236	Lors d'un des gros accidents 	survenus	 dernièrement, la marchandise transportée n'était pas dangereuse en soi. 
fr_partut-ud-239	Pour 	terminer	, je voudrais dire qu'il est nécessaire d'aborder la sécurité de tous les types de transport. 
fr_partut-ud-242	Comme je le dirai lors du débat sur l'Erika, nous n'attendons pas qu'une catastrophe 	survienne	 pour nous consacrer corps et âme à l'aspect de la sécurité, mais nous travaillons dessus en marge de ces circonstances, qui ne font que mettre en évidence l'urgence d'une réponse efficace à ce type de problèmes. 
fr_partut-ud-243	Je tiens à réitérer mes remerciements à tous les 	intervenants	 et plus particulièrement au rapporteur, M. Koch. 
fr_partut-ud-250	Il s'agit en particulier des annexes qui ne pourront être 	adaptées	 pour répondre à l'évolution technique et industrielle. 
fr_partut-ud-253	L'inaction de l'Union Européenne obligerait les états membres à modifier leurs dispositions légales en la matière pour un bref laps de temps, à 	savoir	 jusqu'à la conclusion des travaux du CEN, ce qui entraînerait des coûts et des incertitudes inutiles. 
fr_partut-ud-254	La modification qui est à l'ordre du jour n'entraîne donc aucune modification de l'harmonisation communautaire 	existante	 en matière de transports de marchandises dangereuses. 
fr_partut-ud-257	les états membres bénéficiant de compétences 	accrues	. 
fr_partut-ud-258	La commission européenne décide si les états membres peuvent édicter des dispositions spécifiques 	déterminées	, la procédure de réglementation prévoyant qu'elle bénéficie à cette fin du soutien d'un comité d'experts en matière de transports de marchandises dangereuses. 
fr_partut-ud-260	Sur deux cas précis, les propositions d'amendement introduites par la commission et y ayant fait l'objet d'un accord unanime portent justement sur cette procédure comitologique 	modifiée	. 
fr_partut-ud-261	Nous voudrions être sûrs que cela soit déjà signalé dans les considérants et que le délai clairement 	formulé	 dans lequel le conseil doit prendre une décision soit fixé à un maximum de trois mois. 
fr_partut-ud-261	Nous voudrions être sûrs que cela soit déjà signalé dans les 	considérants	 et que le délai clairement formulé dans lequel le conseil doit prendre une décision soit fixé à un maximum de trois mois. 
fr_partut-ud-262	On insiste en outre sur la nécessité d'une transparence 	accrue	. 
fr_partut-ud-268	C'est une bonne chose que cette directive soit 	arrêtée	 maintenant, car sinon les états membres seraient obligés de modifier leur législation nationale pour une période transitoire très courte, ce qui ne ferait qu'entraîner des coûts inutiles et augmenterait encore une fois le mécontentement des gens face à la bureaucratie communautaire. 
fr_partut-ud-277	J'ai trouvé cela tout à 	fait	 exceptionnel. 
fr_partut-ud-278	Pour ce qui est du thème proprement dit, je pense que les citoyens d'Europe doivent pouvoir compter sur le fait que les marchandises transportées sur les routes, les voies ferrées et autres voies de transport européennes, qu'il s'	agisse	 ou non de marchandises dangereuses, sont transportées d'une manière aussi sûre que possible. 
fr_partut-ud-278	Pour ce qui est du thème proprement 	dit	, je pense que les citoyens d'Europe doivent pouvoir compter sur le fait que les marchandises transportées sur les routes, les voies ferrées et autres voies de transport européennes, qu'il s'agisse ou non de marchandises dangereuses, sont transportées d'une manière aussi sûre que possible. 
fr_partut-ud-281	Le rapporteur, M. Koch, que nous remercions pour le travail qu'il a accompli, a signalé que, dans le fond, tout ceci pourrait déjà être un peu plus avancé sans la négligence du CEN, qui a énormément tardé à 	élaborer	 et à harmoniser la directive. 
fr_partut-ud-283	Si nous voulons faire en sorte que fonctionne réellement le marché commun des transports à l'échelle de l'union, il est important non seulement que des règles 	existent	, mais que, dans toute la mesure du possible, ces règles nous soient communes. 
fr_partut-ud-284	Enfin, je voudrais commenter un troisième point qui me paraît également essentiel, à 	savoir	 une proposition d'amendement qui a été déposée par M. Ari Vatanen. 
fr_partut-ud-295	Nous regrettons tous que le comité européen de normalisation (CEN) n'ait pas été capable de réaliser dans les délais 	fixés	 la modification des dispositions nécessaire pour parvenir à une harmonisation appropriée au sein de l'Union Européenne. 
fr_partut-ud-297	Il y 	a	 quelques instants, M. Vatanen nous parlait de températures inférieures, non plus à -20 degrés, mais à -40 degrés. 
fr_partut-ud-298	Nous acceptons bien évidemment cet amendement, qui est tout à fait 	justifié	, et je pense qu'il faut introduire des circonstances concrètes qui témoignent de la variété climatique de l'Union Européenne, qui se traduit parfois en spécificités et en exigences concrètes au moment où il s'agit d'envisager des normalisations ou caractérisations de type technique. 
fr_partut-ud-298	Nous acceptons bien évidemment cet amendement, qui est tout à 	fait	 justifié, et je pense qu'il faut introduire des circonstances concrètes qui témoignent de la variété climatique de l'Union Européenne, qui se traduit parfois en spécificités et en exigences concrètes au moment où il s'agit d'envisager des normalisations ou caractérisations de type technique. 
fr_partut-ud-304	Monsieur le Président, je suis particulièrement ravi de ce que ma première intervention au Parlement européen porte sur ce que la région du Royaume-uni que je représente au sein de ce Parlement, à 	savoir	 le pays de Galles, considère comme le sujet le plus important. 
fr_partut-ud-317	Monsieur le président, notre commission traite ces questions sous bien des angles différents, et pour 	commencer	 je parlerai de l'angle de la recherche. 
fr_partut-ud-318	Nous estimons fort positif que, dans ses conclusions, le rapporteur ait tenu compte de notre proposition selon laquelle les infrastructures de la recherche devraient être élargies dans les pays de la cohésion en implantant les écoles professionnelles et les universités de telle sorte qu'elles servent mieux les populations des régions les moins développées et qu'elles permettent aux personnes 	formées	 de demeurer dans leur région d'origine. 
fr_partut-ud-333	Nous espérons que la commission pourra nous rassurer et nous dire qu'il s'	agit	 d'un oubli, qu'elle réparera de manière constructive. 
fr_partut-ud-337	Ceci, ajouté aux déficiences des réseaux d'infrastructures et de services et à une offre d'emploi généralement très 	limitée	 et tout au plus saisonnière et peu diversifiée, accentuent l'exode rural. 
fr_partut-ud-338	Les conséquences ne se font pas 	attendre	. 
fr_partut-ud-339	Ce sont les jeunes qui 	disparaissent	, qui acquièrent une formation et trouvent un emploi en dehors des zones rurales, ce qui a une incidence défavorable sur ces zones. 
fr_partut-ud-353	Et pour arriver à un élan plus rapide et efficace dans la satisfaction de ces objectifs, nous pensons qu'il est nécessaire que participent à cette initiative les créateurs d'emploi, les véritables entrepreneurs et ceux qui garantissent vraiment les nouvelles sources d'emploi, à 	savoir	 les patrons. 
fr_partut-ud-355	Si ce n'est pas le cas, si les patrons se sentent exclus, s'ils ne peuvent 	participer	, et je ne parle pas seulement de la gestion, mais également de la réception des fonds, nous aurons manqué une chance d'atteindre nos objectifs plus rapidement. 
fr_partut-ud-355	Si ce n'est pas le cas, si les patrons se sentent 	exclus	, s'ils ne peuvent participer, et je ne parle pas seulement de la gestion, mais également de la réception des fonds, nous aurons manqué une chance d'atteindre nos objectifs plus rapidement. 
fr_partut-ud-357	Tout ceci ­ j'	insiste	 ­ avec la participation de l'entreprise privée qui, en unissant ses efforts à ceux des administrations publiques, en les complétant, sans qu'il y ait aucune obstruction ou exclusion, est celle qui créera des richesses sociales et des postes de travail. 
fr_partut-ud-370	Pour 	conclure	, je dirai que nous devons faire en sorte que les lignes directrices soient larges, indicatives et souples, afin d'aider nos gestionnaires de programmes et les utilisateurs des crédits et de valoriser au mieux les potentialités de nos nouveaux domaines de régénération. 
fr_partut-ud-373	Le rapporteur constate également fort justement que le parlement n'a pas été consulté en temps 	voulu	 au sujet des orientations. 
fr_partut-ud-380	Il est particulièrement 	important	 de faire participer les PME à cette élaboration et à cette mise en oeuvre. 
fr_partut-ud-381	Notre groupe estime également qu'il 	importe	 d'accorder une plus grande attention aux régions d'outre-mer et aux autres régions périphériques et veut que l'on augmente l'interaction entre la ville et la campagne. 
fr_partut-ud-384	Souvent, des ressources ont été attribuées à des projets n'ayant laissé aucun profit durable à la région 	concernée	. 
fr_partut-ud-388	Ce rapport est tout à fait bon et notre groupe le 	soutient	. 
fr_partut-ud-390	Compte tenu de ce qui précède, nous devons exiger en tout cas, à partir de cette assemblée, que les cadres communautaires d'appui pour la période en question soient 	étudiés	 et soumis au débat dans ce parlement, avant leur adoption et à la lumière des orientations que nous présentons aujourd'hui. 
fr_partut-ud-390	Compte tenu de ce qui 	précède	, nous devons exiger en tout cas, à partir de cette assemblée, que les cadres communautaires d'appui pour la période en question soient étudiés et soumis au débat dans ce parlement, avant leur adoption et à la lumière des orientations que nous présentons aujourd'hui. 
fr_partut-ud-395	Si nous prenons comme seul indicateur le produit intérieur brut par habitant, nous risquons de nous 	tromper	. 
fr_partut-ud-399	Ceci oblige le parlement européen, le commissaire et la commission à agir de manière 	décidée	 et stratégique. 
fr_partut-ud-406	Je veux croire qu'il est d'accord, étant 	donné	 son expérience passée de président régional, pour proposer des indicateurs et une stratégie en faveur de la cohésion économique et sociale, et pas seulement de la productivité. 
fr_partut-ud-408	Les États membres sont instamment invités à accorder davantage d'importance aux stratégies 	intégrées	 afin de revitaliser les rapports entres les zones urbaines et rurales. 
fr_partut-ud-420	Il n'est pas accordé à cette question l'importance qui 	conviendrait	, et ce n'est pas la première fois: 
fr_partut-ud-422	Monsieur le commissaire, nous continuerons à la relancer, car à l'article 158, paragraphe 1, du traité d'Amsterdam, il y a une disposition qui prévoit une politique 	intégrée	 pour les îles. 
fr_partut-ud-425	Je suis tout à fait convaincu que ce code sera 	respecté	 et que le parlement sera tenu informé de toutes les évolutions et des détails de la mise en oeuvre des programmes. 
fr_partut-ud-425	Je suis tout à fait 	convaincu	 que ce code sera respecté et que le parlement sera tenu informé de toutes les évolutions et des détails de la mise en oeuvre des programmes. 
fr_partut-ud-430	En peu de mots, je voudrais dire que nous entrons dans une période de gestion de la programmation 2000-2006, qui ne doit pas être une période de routine, pour la simple et bonne raison que nous avons deux grands défis à 	relever	. 
fr_partut-ud-432	Les subventions ne 	suffisent	 pas pour faire du développement, quand font défaut les infrastructures ou les services publics. 
fr_partut-ud-439	Il ne faudrait pas, comme ont tendance à le vouloir les états, que l'Europe 	disparaisse	 complètement. 
fr_partut-ud-440	Aujourd'hui, les opinions publiques, la presse, nous accusent d'être aux 	abonnés	 absents alors que nous allons financer une grande part des efforts nationaux. 
fr_partut-ud-442	Je pense qu'il faudrait aussi que nous instaurions ou que nous demandions aux états membres qu'ils assurent une information sur les aides européennes, chaque fois qu'elles sont 	mobilisées	 pour réparer les dégâts causés par des catastrophes naturelles ou des accidents. 
fr_partut-ud-442	Je pense qu'il faudrait aussi que nous 	instaurions	 ou que nous demandions aux états membres qu'ils assurent une information sur les aides européennes, chaque fois qu'elles sont mobilisées pour réparer les dégâts causés par des catastrophes naturelles ou des accidents. 
fr_partut-ud-448	Nous proposons en particulier un impôt unifié sur le capital, qui permettrait d'alimenter des fonds 	utilisés	 pour accompagner l'harmonisation des systèmes de protection sociale et la réduction du temps de travail au niveau européen. 
fr_partut-ud-449	Or, la commission, 	tenue	 de présenter des orientations, ne le fait qu'avec regret et de façon floue. 
fr_partut-ud-450	Le rapport 	proposé	 aujourd'hui redonne sa place au politique. 
fr_partut-ud-455	Pour ce faire, il 	faut	 une Commission européenne qui, au-delà de ses bonnes intentions, clarifie ses lignes directrices et s'engage un maximum dans le contrôle de l'utilisation de ces ressources par les états membres. 
fr_partut-ud-461	Combien 	coûte	 l'inscription à Facebook? 
fr_partut-ud-463	Facebook est un site gratuit et vous n'aurez jamais à 	payer	 pour continuer à utiliser le site. 
fr_partut-ud-464	En revanche, vous avez la possibilité d'acheter des crédits Facebook, qui peuvent être 	utilisés	 pour envoyer des cadeaux ou acheter des articles sur des applications ou des jeux. 
fr_partut-ud-466	Quel est l'âge minimal 	requis	 pour s'inscrire à Facebook? 
fr_partut-ud-492	Le mot de passe que vous choisissez devrait être facile à mémoriser mais difficile à 	deviner	. 
fr_partut-ud-492	Le mot de passe que vous choisissez devrait être facile à 	mémoriser	 mais difficile à deviner. 
fr_partut-ud-500	Cette section ne s'	affichera	 pas si vous avez déjà ajouté une question de sécurité à votre compte. 
fr_partut-ud-504	Assurez-vous que votre réponse est suffisamment précise pour être impossible à 	deviner	. 
fr_partut-ud-509	Touchez vos clients 	ciblés	. 
fr_partut-ud-512	Essayez des images et des textes simples pour vos publicités et utilisez ce qui 	marche	. 
fr_partut-ud-515	Utilisez notre bouton «j'	aime	» pour accroître l'impact de votre publicité. 
fr_partut-ud-519	Ajustez votre budget quotidien à n'	importe	 quel moment. 
fr_partut-ud-522	Facebook fait désormais partie de la vie de tous les jours, ce qui vous permet de communiquer avec des prospects réellement 	intéressés	 par vos produits. 
fr_partut-ud-541	Le bouton ""s'	abonner	"". 
fr_partut-ud-545	Cliquez sur bouton ""s'	abonner	"" sur le profil d'une personne pour obtenir ses mises à jour publiques dans votre fil d'actualité. 
fr_partut-ud-548	Utilisez le bouton ""s'	abonner	"" pour choisir ce que vous voyez dans votre fil d'actualité. 
fr_partut-ud-551	Permettez à tout le monde de 	voir	 vos mises à jour publiques. 
fr_partut-ud-555	Pourquoi est-ce que tous les profils n'ont pas un bouton ""s'	abonner	""? 
fr_partut-ud-556	Seules les personnes qui ont activé la fonction d'abonnement auront un bouton ""s'	abonner	"" sur leur profil. 
fr_partut-ud-559	Lorsque vous activez la fonctionnalité d'abonnement, un bouton ""s'	abonner	"" est affiché sur votre profil. 
fr_partut-ud-561	Si j'autorise l'abonnement, quelles seront les mises à jour que les 	abonnés	 pourront voir? 
fr_partut-ud-562	Les 	abonnés	 voient uniquement les choses que vous publiez avec le paramètre public. 
fr_partut-ud-564	Pour en apprendre plus sur le bouton ""s'	abonner	"", consultez les Aide. 
fr_partut-ud-579	Il 	convient	 donc d'agir réellement sur la demande et de fixer des objectifs substantiels en la matière. 
fr_partut-ud-580	(5) Il convient d'agir au cours de la phase de conception du produit consommateur d'énergie, puisqu'il s'avère que la pollution causée durant le cycle de vie d'un produit est déterminée à ce stade, et que la plupart des coûts 	associés	 sont engagés pendant cette phase. 
fr_partut-ud-580	(5) Il convient d'agir au cours de la phase de conception du produit consommateur d'énergie, puisqu'il s'	avère	 que la pollution causée durant le cycle de vie d'un produit est déterminée à ce stade, et que la plupart des coûts associés sont engagés pendant cette phase. 
fr_partut-ud-580	(5) Il 	convient	 d'agir au cours de la phase de conception du produit consommateur d'énergie, puisqu'il s'avère que la pollution causée durant le cycle de vie d'un produit est déterminée à ce stade, et que la plupart des coûts associés sont engagés pendant cette phase. 
fr_partut-ud-581	(6) Il 	convient	 d'établir un cadre cohérent pour l'application des exigences communautaires en matière d'écoconception applicables aux produits consommateurs d'énergie en vue d'assurer la libre circulation des produits qui y sont conformes et d'améliorer leur impact global sur l'environnement. 
fr_partut-ud-583	(7) Il convient de fixer les exigences d'écoconception en tenant compte des objectifs et des priorités du sixième programme d'action communautaire pour l'environnement, y compris, le cas échéant, les objectifs valides dans le cadre des stratégies thématiques pertinentes du 	dit	 programme. 
fr_partut-ud-583	(7) Il convient de fixer les exigences d'écoconception en tenant compte des objectifs et des priorités du sixième programme d'action communautaire pour l'environnement, y compris, le cas 	échéant	, les objectifs valides dans le cadre des stratégies thématiques pertinentes du dit programme. 
fr_partut-ud-583	(7) Il convient de fixer les exigences d'écoconception en tenant compte des objectifs et des priorités du sixième programme d'action communautaire pour l'environnement, y 	compris	, le cas échéant, les objectifs valides dans le cadre des stratégies thématiques pertinentes du dit programme. 
fr_partut-ud-583	(7) Il 	convient	 de fixer les exigences d'écoconception en tenant compte des objectifs et des priorités du sixième programme d'action communautaire pour l'environnement, y compris, le cas échéant, les objectifs valides dans le cadre des stratégies thématiques pertinentes du dit programme. 
fr_partut-ud-585	Le développement durable requiert également un examen adéquat de l'impact sanitaire, social et économique des mesures 	envisagées	. 
fr_partut-ud-594	Compte tenu de la nécessité urgente de contribuer au respect des engagements pris dans le cadre du protocole de Kyoto à la convention-cadre des Nations Unies sur les changements climatiques (CCNUCC), et sans préjudice de l'approche intégrée encouragée dans la présente directive, il 	convient	 d'accorder une certaine priorité aux mesures qui présentent un fort potentiel de réduction à faible coût des émissions de gaz à effet de serre. 
fr_partut-ud-594	Compte tenu de la nécessité urgente de contribuer au respect des engagements pris dans le cadre du protocole de Kyoto à la convention-cadre des Nations Unies sur les changements climatiques (CCNUCC), et sans préjudice de l'approche 	intégrée	 encouragée dans la présente directive, il convient d'accorder une certaine priorité aux mesures qui présentent un fort potentiel de réduction à faible coût des émissions de gaz à effet de serre. 
fr_partut-ud-597	(15) Les produits ou technologies les plus performants disponibles sur le marché, y 	compris	 sur les marchés internationaux, étant à prendre pour référence, le niveau des exigences d'écoconception devrait être établi sur la base d'analyses technique, économique et environnementale. 
fr_partut-ud-599	Il y a lieu de consulter et de faire 	collaborer	 activement les parties intéressées à cette analyse. 
fr_partut-ud-599	Il y a lieu de 	consulter	 et de faire collaborer activement les parties intéressées à cette analyse. 
fr_partut-ud-603	(16) Il 	convient	 d'accorder la priorité aux solutions alternatives d'action comme l'autorégulation par l'industrie, lorsque cette action peut permettre d'atteindre les objectifs stratégiques plus rapidement ou de manière moins onéreuse que des exigences contraignantes. 
fr_partut-ud-606	libre participation, valeur ajoutée, représentativité, objectifs quantifiés et 	échelonnés	, participation de la société civile, suivi et rapports, rapport coût/efficacité de la gestion d'une initiative d'autorégulation et durabilité. 
fr_partut-ud-606	libre participation, valeur ajoutée, représentativité, objectifs 	quantifiés	 et échelonnés, participation de la société civile, suivi et rapports, rapport coût/efficacité de la gestion d'une initiative d'autorégulation et durabilité. 
fr_partut-ud-607	(19) Le chapitre 6 de la communication de la commission intitulée ""les accords environnementaux conclus au niveau communautaire dans le cadre du plan d'action"" 	simplifier	 et améliorer l'environnement réglementaire ""pourrait fournir des orientations utiles pour évaluer l'autorégulation de l'industrie dans le cadre de la présente directive. 
fr_partut-ud-612	(22) Lors de l'élaboration des mesures d'exécution et de son plan de travail, la commission devrait consulter des représentants des états membres, ainsi que les parties intéressées concernées par le groupe de produits, par exemple le secteur de production, y 	compris	 les PME et le secteur artisanal, les syndicats, les opérateurs commerciaux, les détaillants, les importateurs, les associations de protection de l'environnement et les organisations de consommateurs. 
fr_partut-ud-613	(23) Lorsque la commission élabore des mesures d'exécution, elle devrait également tenir dûment compte de la législation nationale existante en matière d'environnement dont les états membres ont fait valoir qu'elle devrait être préservée, en particulier pour ce qui est des substances toxiques, et éviter de diminuer les niveaux de protection existants et 	justifiés	 dans les états membres. 
fr_partut-ud-613	(23) Lorsque la commission élabore des mesures d'exécution, elle devrait également tenir dûment compte de la législation nationale existante en matière d'environnement dont les états membres ont fait valoir qu'elle devrait être préservée, en particulier pour ce qui est des substances toxiques, et éviter de diminuer les niveaux de protection 	existants	 et justifiés dans les états membres. 
fr_partut-ud-613	(23) Lorsque la commission élabore des mesures d'exécution, elle devrait également tenir dûment compte de la législation nationale 	existante	 en matière d'environnement dont les états membres ont fait valoir qu'elle devrait être préservée, en particulier pour ce qui est des substances toxiques, et éviter de diminuer les niveaux de protection existants et justifiés dans les états membres. 
fr_partut-ud-614	(24) Il 	convient	 d'accorder une considération particulière aux modules et règles destinés à être utilisés dans les directives d'harmonisation technique qui sont prévus par la décision 93/465/CEE du Conseil du 22 juillet 1993 concernant les modules relatifs aux différentes phases des procédures d'évaluation de la conformité et les règles d'apposition et d'utilisation du marquage «CE» de conformité, destinés à être utilisés dans les directives d'harmonisation technique (1). 
fr_partut-ud-617	L'échange d'informations sur les performances environnementales durant le cycle de vie et sur les résultats obtenus grâce aux solutions en matière de conception devrait également être 	facilité	. 
fr_partut-ud-623	Une fois la référence à une telle norme publiée au journal officiel de l'Union Européenne, une présomption de conformité avec les exigences 	correspondantes	 fixées dans la mesure d'exécution adoptée sur la base de la présente directive devrait découler du respect de cette norme, même s'il devrait être possible d'attester cette conformité par d'autres moyens. 
fr_partut-ud-624	(30) Une des principales fonctions des normes 	harmonisées	 devrait être d'aider les fabricants dans l'application des mesures d'exécution adoptées dans le cadre de la présente directive. 
fr_partut-ud-626	Dans le cas des exigences d'écoconception génériques, les normes 	harmonisées	 pourraient contribuer de façon importante à guider les fabricants dans l'établissement du profil écologique de leurs produits conformément aux exigences de la mesure d'exécution applicable. 
fr_partut-ud-627	Ces normes devraient indiquer clairement le lien entre leurs dispositions et les exigences 	visées	. 
fr_partut-ud-628	Les normes 	harmonisées	 ne devraient pas avoir pour finalité d'établir des limites pour les caractéristiques environnementales. 
fr_partut-ud-629	(31) Aux fins des définitions utilisées dans la présente directive, il est utile de se 	référer	 aux normes internationales pertinentes, telles que la norme ISO 14040. 
fr_partut-ud-630	(32) La présente directive est conforme à certains principes de mise en oeuvre de la nouvelle approche établie dans la résolution du conseil du 7 mai 1985 concernant une nouvelle approche en matière d'harmonisation technique et de normalisation et de la référence à des normes européennes 	harmonisées	. 
fr_partut-ud-631	La résolution du Conseil du 28 octobre 1999 sur le rôle de la normalisation en Europe (2) recommandait que la commission examine si le principe de la nouvelle approche pouvait être étendu aux secteurs qui ne sont pas encore couverts, en vue d'améliorer et de 	simplifier	 la législation dans tous les cas où cela est possible. 
fr_partut-ud-631	La résolution du Conseil du 28 octobre 1999 sur le rôle de la normalisation en Europe (2) recommandait que la commission examine si le principe de la nouvelle approche pouvait être étendu aux secteurs qui ne sont pas encore 	couverts	, en vue d'améliorer et de simplifier la législation dans tous les cas où cela est possible. 
fr_partut-ud-632	(33) La présente directive est complémentaire par rapport aux instruments communautaires 	existants	, tels que la directive 92/75/CEE du conseil du 22 septembre 1992 concernant l'indication de la consommation des appareils domestiques en énergie et en autres ressources par voie d'étiquetage et d'informations uniformes relatives aux produits (3), le règlement (CE) no 1980/2000 du parlement européen et du conseil du 17 juillet 2000 établissant un système communautaire révisé d'attribution du label écologique (4), le règlement (CE) no 2422/2001 du parlement européen et du conseil du 6 novembre 2001 concernant un programme communautaire d'étiquetage relatif à l'efficacité énergétique des équipements de bureau (5), la directive 2002/96/CE du parlement européen et du conseil du 27 janvier 2003 relative aux déchets d'équipements électriques et électroniques (DEEE) (6), la directive 2002/95/CE du parlement européen et du conseil du 27 janvier 2003 relative à la limitation de l'utilisation de certaines substances dangereuses dans les équipements électriques et électroniques (7) et la directive 76/769/CEE du conseil du 27 juillet 1976 concernant le rapprochement des dispositions législatives, réglementaires et administratives des états membres relatives à la limitation de la mise sur le marché et de l'emploi de certaines substances et préparations dangereuses (8). 
fr_partut-ud-634	(34) Étant donné que la directive 92/42/CEE du conseil du 21 mai 1992 concernant les exigences de rendement pour les nouvelles chaudières à eau chaude alimentées en combustibles liquides ou gazeux (9), la directive 96/57/CE du parlement européen et du conseil du 3 septembre 1996 concernant les exigences en matière de rendement énergétique des réfrigérateurs, congélateurs et appareils combinés électriques à usage 	ménager	 (10) et la directive 2000/55/CE du parlement européen et du conseil du 18 septembre 2000 établissant des exigences de rendement énergétique applicables aux ballasts pour l'éclairage fluorescent (11) contiennent déjà des dispositions relatives à la révision des exigences d'efficacité énergétique, elles devraient être intégrées dans le présent cadre. 
fr_partut-ud-634	(34) Étant donné que la directive 92/42/CEE du conseil du 21 mai 1992 concernant les exigences de rendement pour les nouvelles chaudières à eau chaude alimentées en combustibles liquides ou gazeux (9), la directive 96/57/CE du parlement européen et du conseil du 3 septembre 1996 concernant les exigences en matière de rendement énergétique des réfrigérateurs, congélateurs et appareils 	combinés	 électriques à usage ménager (10) et la directive 2000/55/CE du parlement européen et du conseil du 18 septembre 2000 établissant des exigences de rendement énergétique applicables aux ballasts pour l'éclairage fluorescent (11) contiennent déjà des dispositions relatives à la révision des exigences d'efficacité énergétique, elles devraient être intégrées dans le présent cadre. 
fr_partut-ud-635	(35) La directive 92/42/CEE prévoit un système de classement par étoiles 	destiné	 à identifier la performance énergétique des chaudières. 
fr_partut-ud-637	(36) Les exigences établies dans la directive 78/170/CEE du conseil du 13 février 1978 portant sur la performance des générateurs de chaleur utilisés pour le chauffage de locaux et la production d'eau chaude dans les immeubles non industriels neufs ou 	existants	 ainsi que sur l'isolation de la distribution de chaleur et d'eau chaude sanitaire dans les nouveaux immeubles non industriels (1) ont été remplacées par les dispositions de la directive 92/42/CEE, de la directive 90/396/CEE du conseil du 29 juin 1990 relative au rapprochement des législations des états membres concernant les appareils à gaz (2) et de la directive 2002/91/CE du parlement européen et du conseil du 16 décembre 2002 sur la performance énergétique des bâtiments (3). 
fr_partut-ud-638	Il 	convient	 par conséquent d'abroger la directive 78/170/CEE. 
fr_partut-ud-640	- proposition de décision du conseil 	modifiant	 et prorogeant la décision du conseil du 17 décembre 2001 établissant un programme d'action en matière d'échanges, d'assistance et de formation, pour la protection de l'euro contre le faux monnayage (programme «Pericles»). 
fr_partut-ud-641	Proposition de décision du conseil élargissant aux états membres non participants l'application de la décision du conseil 	modifiant	 et prorogeant la décision du conseil du 17 décembre 2001 établissant un programme d'action en matière d'échanges, d'assistance et de formation, pour la protection de l'euro contre le faux monnayage (programme «Pericles»). 
fr_partut-ud-641	Proposition de décision du conseil élargissant aux états membres non 	participants	 l'application de la décision du conseil modifiant et prorogeant la décision du conseil du 17 décembre 2001 établissant un programme d'action en matière d'échanges, d'assistance et de formation, pour la protection de l'euro contre le faux monnayage (programme «Pericles»). 
fr_partut-ud-642	Le programme Pericles, programme communautaire en matière d'échange, d'assistance et de formation, pour la protection de l'euro contre le faux monnayage, a été établi par la décision du conseil du 17 décembre 2001 (2001/923/CE) et vise à appuyer et à compléter les actions engagées par les états membres et les programmes 	existants	 en matière de protection de l'euro contre le faux monnayage. 
fr_partut-ud-642	Le programme Pericles, programme communautaire en matière d'échange, d'assistance et de formation, pour la protection de l'euro contre le faux monnayage, a été établi par la décision du conseil du 17 décembre 2001 (2001/923/CE) et vise à 	appuyer	 et à compléter les actions engagées par les états membres et les programmes existants en matière de protection de l'euro contre le faux monnayage. 
fr_partut-ud-646	L'article 13, paragraphe 3, de la 	dite	 décision dispose que la commission présente au parlement européen et au conseil, au plus tard le 30 juin 2005: 
fr_partut-ud-648	et - une communication sur l'opportunité de 	poursuivre	 et adapter le programme, accompagnée d'une proposition appropriée. 
fr_partut-ud-651	Parallèlement, le nombre de fausses pièces en euros continue d'augmenter, tout en 	demeurant	 limité dans une perspective historique. 
fr_partut-ud-651	Parallèlement, le nombre de fausses pièces en euros continue d'	augmenter	, tout en demeurant limité dans une perspective historique. 
fr_partut-ud-661	Il convient de rester vigilant pour 	maintenir	 et faire progresser les résultats actuels dans la lutte contre la contrefaçon de l'euro. 
fr_partut-ud-661	Il 	convient	 de rester vigilant pour maintenir et faire progresser les résultats actuels dans la lutte contre la contrefaçon de l'euro. 
fr_partut-ud-665	Sur la base des questionnaires adressés aux organisateurs et aux participants et des discussions avec les parties 	concernées	, il est parvenu aux principales conclusions suivantes [6]: 
fr_partut-ud-670	- les activités 	examinées	 ont été jugées pertinentes au regard des principaux objectifs du programme; 
fr_partut-ud-675	- le programme doit demeurer accessible à tous les états membres, mais il 	convient	 d'accorder une priorité (dans un premier temps) à ceux ayant une faible participation ou à ceux qui n'ont pas réalisé d'actions au cours du premier programme, ainsi qu'aux nouveaux états membres; 
fr_partut-ud-676	- il 	convient	 de mettre l'accent sur la formation pratique. 
fr_partut-ud-677	La priorité devrait être donnée aux échanges de personnel et aux formations spécifiques, y 	compris	 les études de cas. 
fr_partut-ud-682	L'exécution du programme a 	démarré	 lentement, essentiellement parce que celui-ci a été adopté en décembre 2001. 
fr_partut-ud-691	La plupart des actions 	exécutées	 consistent dans des conférences, des séminaires et des ateliers, ainsi que dans des cours de formation spécialisée. 
fr_partut-ud-693	À la suite de l'élargissement, ce type d'activité devrait continuer à se 	développer	, ce que recommande également l'évaluateur du programme Pericles. 
fr_partut-ud-697	Au début, les 	participants	 étaient en grande majorité des agents des services répressifs, ce qui montrait que la priorité était d'établir des liens professionnels plus étroits afin de lutter plus efficacement contre la contrefaçon de l'euro. 
fr_partut-ud-698	À cet égard, le rapport d'évaluation (p.10 et 11) indique que, jusqu'en mars 2004, 65% des 	participants	 provenaient essentiellement des services répressifs. 
fr_partut-ud-699	À partir de 2003, on observe une plus grande participation des autorités judiciaires, tandis qu'à partir de 2004, celle du secteur financier 	augmente	 (intermédiaires financiers du secteur public, banques centrales nationales, banques commerciales et autres institutions financières). 
fr_partut-ud-700	Cette évolution va dans le sens de la recommandation de l'évaluateur, l'organisation de séminaires plus techniques étant également 	encouragée	. 
fr_partut-ud-701	S'	agissant	 de la provenance des participants, le rapport d'évaluation indique que ces derniers provenaient de 76 pays, en majorité des états membres. 
fr_partut-ud-703	Cette situation peut s'expliquer davantage par des éléments organisationnels que par des éléments structurels et des efforts sont 	entrepris	 actuellement pour parvenir à un équilibre. 
fr_partut-ud-713	En conséquence, le caractère transnational et pluridisciplinaire 	exigé	 par l'article 3 de la décision Pericles a été respecté, puisqu'il est recherché tant sur le plan de l'expérience professionnelle des participants que du contenu des actions. 
fr_partut-ud-725	Conformément à l'analyse qui précède et eu égard aux conclusions de l'évaluateur du programme Pericles, la présente communication est accompagnée d'une proposition visant à adapter et à 	poursuivre	 ce programme. 
fr_partut-ud-725	Conformément à l'analyse qui 	précède	 et eu égard aux conclusions de l'évaluateur du programme Pericles, la présente communication est accompagnée d'une proposition visant à adapter et à poursuivre ce programme. 
fr_partut-ud-726	Conformément à l'article 13 de la décision du conseil du 17 décembre 2001 établissant un programme d'action en matière d'échanges, d'assistance et de formation, pour la protection de l'euro contre le faux monnayage (le programme «Pericles»), et compte tenu du rapport d'évaluation Pericles du 30 novembre 2004, il est proposé de 	proroger	 et de modifier la décision du conseil. 
fr_partut-ud-727	La période de prorogation proposée est de six ans et le montant de référence reste identique, à 	savoir	 d'un million d'euros par an. 
fr_partut-ud-727	La période de prorogation 	proposée	 est de six ans et le montant de référence reste identique, à savoir d'un million d'euros par an. 
fr_partut-ud-728	Les adaptations 	proposées	 concernent l'augmentation de la proportion de cofinancement fournie par le budget communautaire; 
fr_partut-ud-732	- de poursuivre la surveillance afin de 	maintenir	 ou de réduire le niveau actuel de la contrefaçon de billets en euros et d'éviter toute augmentation de la contrefaçon des pièces en euros qui altérerait la confiance du public; 
fr_partut-ud-733	- de former/informer le nouveau personnel et d'étendre la formation aux secteurs qui ont moins bénéficié du programme Pericles, à 	savoir	 les agents financiers, le ministère public et les techniciens; 
fr_partut-ud-733	- de 	former	/informer le nouveau personnel et d'étendre la formation aux secteurs qui ont moins bénéficié du programme Pericles, à savoir les agents financiers, le ministère public et les techniciens; 
fr_partut-ud-740	Considérant que la méconnaissance et le mépris des droits de l'homme ont conduit à des actes de barbarie qui révoltent la conscience de l'humanité et que l'avènement d'un monde où les êtres humains seront libres de parler et de 	croire	, libérés de la terreur et de la misère, a été proclamé comme la plus haute aspiration de l'homme. 
fr_partut-ud-740	Considérant que la méconnaissance et le mépris des droits de l'homme ont conduit à des actes de barbarie qui révoltent la conscience de l'humanité et que l'avènement d'un monde où les êtres humains seront libres de 	parler	 et de croire, libérés de la terreur et de la misère, a été proclamé comme la plus haute aspiration de l'homme. 
fr_partut-ud-751	2. De plus, il ne sera 	fait	 aucune distinction fondée sur le statut politique, juridique ou international du pays ou du territoire dont une personne est ressortissante, que ce pays ou territoire soit indépendant, sous tutelle, non autonome ou soumis à une limitation quelconque de souveraineté. 
fr_partut-ud-760	Nul ne peut être arbitrairement arrêté, détenu ou 	exilé	. 
fr_partut-ud-760	Nul ne peut être arbitrairement arrêté, 	détenu	 ou exilé. 
fr_partut-ud-760	Nul ne peut être arbitrairement 	arrêté	, détenu ou exilé. 
fr_partut-ud-764	De même, il ne sera 	infligé	 aucune peine plus forte que celle qui était applicable au moment où l'acte délictueux a été commis. 
fr_partut-ud-767	1. Toute personne a le droit de 	circuler	 librement et de choisir sa résidence à l'intérieur d'un Etat. 
fr_partut-ud-781	Tout individu a droit à la liberté d'opinion et d'expression, ce qui implique le droit de ne pas être inquiété pour ses opinions et celui de chercher, de recevoir et de répandre, sans considérations de frontières, les informations et les idées par quelque moyen d'expression que ce 	soit	. 
fr_partut-ud-781	Tout individu a droit à la liberté d'opinion et d'expression, ce qui implique le droit de ne pas être inquiété pour ses opinions et celui de chercher, de 	recevoir	 et de répandre, sans considérations de frontières, les informations et les idées par quelque moyen d'expression que ce soit. 
fr_partut-ud-781	Tout individu a droit à la liberté d'opinion et d'expression, ce qui implique le droit de ne pas être inquiété pour ses opinions et celui de 	chercher	, de recevoir et de répandre, sans considérations de frontières, les informations et les idées par quelque moyen d'expression que ce soit. 
fr_partut-ud-784	1. Toute personne a le droit de prendre part à la direction des affaires publiques de son pays, soit directement, soit par l'intermédiaire de représentants librement 	choisis	. 
fr_partut-ud-793	Toute personne a droit au repos et aux loisirs et notamment à une limitation raisonnable de la durée du travail et à des congés 	payés	 périodiques. 
fr_partut-ud-807	Aucune disposition de la présente déclaration ne peut être 	interprétée	 comme impliquant pour un Etat, un groupement ou un individu un droit quelconque de se livrer à une activité ou d'accomplir un acte visant à la destruction des droits et libertés qui y sont énoncés. 
fr_partut-ud-810	Et ces thèmes simples ne sont pas vraiment des thèmes sur la science complexe de ce qui se 	passe	, mais des choses que nous connaissons tous assez bien. 
fr_partut-ud-813	On connaît ça, n'	est	-ce pas? 
fr_partut-ud-820	Rolf Bolin, qui était professeur à la station marine de Hopkin où je travaille, a écrit dans les années 40 que, ""les gaz émanant de la crasse flottante dans les anses du golfe étaient si mauvais qu'ils faisaient même 	noircir	 les peintures au plomb"". 
fr_partut-ud-820	Rolf Bolin, qui était professeur à la station marine de Hopkin où je travaille, a écrit dans les années 40 que, ""les gaz émanant de la crasse 	flottante	 dans les anses du golfe étaient si mauvais qu'ils faisaient même noircir les peintures au plomb"". 
fr_partut-ud-821	Mais savez-vous ce qu'ils disaient en 	sortant	? 
fr_partut-ud-830	Parce que lorsqu'on entasse dans le bas de la pyramide des choses qui ne devraient pas y être, il se 	passe	 des choses bien effrayantes. 
fr_partut-ud-830	Parce que lorsqu'on entasse dans le bas de la pyramide des choses qui ne devraient pas y 	être	, il se passe des choses bien effrayantes. 
fr_partut-ud-831	Maintenant, pour vraiment vous faire 	comprendre	, j'ai pensé à inventer un petit jeu. 
fr_partut-ud-835	Ce qui 	arrivera	 c'est que les chips polystyrène commenceront à voyager dans notre société ici et iront s'accumuler chez les personnes les plus ivres et radines. 
fr_partut-ud-844	Alors, un dauphin, maman dauphin, n'	importe	 quel dauphin - il n'y a qu'une façon pour que le PCB sortent du dauphin. 
fr_partut-ud-851	Alors, la mère peut aller se reproduire, mais quel prix terrible à payer pour l'accumulation de ce polluant dans ces animaux - la mort de leur premier 	né	. 
fr_partut-ud-856	En fait, ce qu'on a fait il y 	a	 quelques années c'était d'apprendre comment on introduit clandestinement un labo de biologie moléculaire à Tokyo et de l'utiliser pour tester génétiquement l'ADN d'échantillons de viande de baleine et identifier ce qu'ils étaient vraiment. 
fr_partut-ud-858	Certains étaient de la viande de baleine illégale, soit dit en 	passant	. 
fr_partut-ud-858	Certains étaient de la viande de baleine illégale, soit 	dit	 en passant. 
fr_partut-ud-865	Il s'	avère	 que beaucoup de dauphins sont vendus comme viande dans le marché de la baleine partout dans le monde. 
fr_partut-ud-867	Nous avons eu ces données il y 	a	 quelques années. 
fr_partut-ud-869	Et je me souviens que j'étais assis à mon bureau et je 	pensais	, ""et bien, je le sais"". 
fr_partut-ud-7	L'oeuvre (telle que 	définie	 ci-dessous) est mise à disposition selon les termes du présent contrat appelé Contrat Public Creative Commons (dénommé ici «CPCC» ou «Contrat»). 
fr_partut-ud-291	Si M. Koch a rédigé son bon rapport, c'	est	 parce que le travail n'a pas été exécuté de manière trop rapide au sein du CEN et de la commission économique des Nations Unies. 
fr_partut-ud-610	(21) Les produits consommateurs d'énergie conformes aux exigences d'écoconception établies dans les mesures d'exécution de la présente directive doivent porter le marquage CE et les informations 	associées	, afin de pouvoir être mis sur le marché intérieur et y circuler librement. 
fr_partut-ud-886	Nous appelons ça la mycophobie, la peur irrationnelle de l'inconnu quand il s'	agit	 de champignons. 
fr_partut-ud-889	En 	fait	, nous sommes plus proches des champignons que de tout autre règne. 
fr_partut-ud-893	Après avoir 	sporulé	, ils pourrissent. 
fr_partut-ud-895	Ils permettent aux arbres de 	pousser	, ils créent les champs de débris qui nourrissent le mycélium. 
fr_partut-ud-896	Et donc, nous voyons ici un champignon en train de 	sporuler	. 
fr_partut-ud-904	Mais ce sont essentiellement des estomacs et des poumons 	externalisés	. 
fr_partut-ud-914	Je pense donc que l'invention de l'internet des ordinateurs est une conséquence inévitable d'un modèle abouti antérieurement et biologiquement 	prouvé	. 
fr_partut-ud-914	Je pense donc que l'invention de l'internet des ordinateurs est une conséquence inévitable d'un modèle 	abouti	 antérieurement et biologiquement prouvé. 
fr_partut-ud-918	Ils sont venus sur la terre il y 	a	 1,3 milliards d'années, et les plantes ont suivi plusieurs centaines de millions d'années plus tard. 
fr_partut-ud-920	Il fait s'	effriter	 les rochers, et c'est la première étape dans la production de sol. 
fr_partut-ud-921	L'acide oxalique est fait de deux molécules de dioxyde de carbone 	assemblées	. 
fr_partut-ud-923	Et toutes sortes d'autres oxalates renferment aussi du dioxyde de carbone par le biais des minéraux qui sont 	formés	 et sortis de la matrice rocheuse. 
fr_partut-ud-927	Il y 	a	 420 millions d'années, cet organisme existait. 
fr_partut-ud-929	Prototaxites, 	couché	, mesurait environ 90 cm de hauteur. 
fr_partut-ud-932	Sur la plupart des terres 	émergées	. 
fr_partut-ud-935	La lumière du soleil n'	arrivait	 plus, et les champignons ont hérité de la Terre. 
fr_partut-ud-936	Les organismes qui s'étaient associés avec des champignons ont été 	récompensés	, parce que les champignons n'ont pas besoin de lumière. 
fr_partut-ud-937	Ainsi, la perspective de champignons existant ailleurs sur d'autres planètes, est, je 	crois	, courue d'avance; 
fr_partut-ud-46	À l'exception des situations expressément mentionnées dans le présent contrat ou dans un autre accord écrit, ou exigées par la loi applicable, l'oeuvre est mise à disposition en l'état sans garantie d'aucune sorte, qu'elle soit expresse ou tacite, y compris à l'égard du 	contenu	 ou de l'exactitude de l'oeuvre. 
fr_partut-ud-46	À l'exception des situations expressément mentionnées dans le présent contrat ou dans un autre accord écrit, ou exigées par la loi applicable, l'oeuvre est mise à disposition en l'état sans garantie d'aucune sorte, qu'elle soit expresse ou tacite, y 	compris	 à l'égard du contenu ou de l'exactitude de l'oeuvre. 
fr_partut-ud-46	À l'exception des situations expressément mentionnées dans le présent contrat ou dans un autre accord 	écrit	, ou exigées par la loi applicable, l'oeuvre est mise à disposition en l'état sans garantie d'aucune sorte, qu'elle soit expresse ou tacite, y compris à l'égard du contenu ou de l'exactitude de l'oeuvre. 
fr_partut-ud-80	Oui, monsieur Evans, je pense qu'une initiative dans le sens que vous venez de 	suggérer	 serait tout à fait appropriée. 
fr_partut-ud-116	Je demande que cette décision soit 	reconsidérée	 car ce n'est pas le cas. 
fr_partut-ud-218	La faute n'en revient certes pas à la seule commission mais je pense que nous devons 	réagir	 plus vite pour parvenir à une harmonisation dans ce domaine aussi. 
fr_partut-ud-372	elle s'est consacrée à fond à sa tâche et, lors de l'examen en commission, a tenu compte des nombreux amendements qui ont été 	apportés	. 
fr_partut-ud-429	En conséquence, il me semble qu'il doit 	anticiper	 et établir les lignes directrices de la révision à mi-parcours de 2003, voire influencer la seconde phase de programmation qui suivra 2003. 
fr_partut-ud-459	Je 	conclus	, Monsieur le Président, en affirmant qu'il est assez grave que la Commission, dans sa communication, n'ait porté que peu attention aux pactes territoriaux et surtout aux modalités de lutte contre le chômage chez les femmes et les jeunes. 
fr_partut-ud-768	2. Toute personne a le droit de quitter tout pays, y 	compris	 le sien, et de revenir dans son pays. 
fr_partut-ud-773	1. À partir de l'âge nubile, l'homme et la femme, sans aucune restriction quant à la race, la nationalité ou la religion, ont le droit de se 	marier	 et de fonder une famille. 
fr_partut-ud-791	3. Quiconque 	travaille	 a droit à une rémunération équitable et satisfaisante lui assurant ainsi qu'à sa famille une existence conforme à la dignité humaine et complétée, s'il y a lieu, par tous autres moyens de protection sociale. 
fr_partut-ud-959	La commission soumet les projets de protocoles au conseil pour qu'ils soient 	conclus	. 
fr_partut-ud-962	Par dérogation à ce qui 	précède	, les procédures de marchés publics engagées après l'adhésion respectent les dispositions pertinentes de l'union. 
fr_partut-ud-964	L'adjudication pour les mesures prises dans le cadre de ces programmes devra avoir lieu dans les deux années qui 	suivront	. 
fr_partut-ud-965	Aucune prolongation du délai d'adjudication n'est 	accordée	. 
fr_partut-ud-966	À titre exceptionnel et dans des cas dûment justifiés, une prolongation 	limitée	 de la durée peut être accordée pour l'exécution des contrats. 
fr_partut-ud-966	À titre exceptionnel et dans des cas dûment 	justifiés	, une prolongation limitée de la durée peut être accordée pour l'exécution des contrats. 
fr_partut-ud-967	Pour ce qui concerne les frais d'audit et d'évaluation, les fonds de préadhésion 	prévus	 peuvent être engagés jusqu'à cinq ans après l'adhésion. 
fr_partut-ud-968	Cependant, les dispositions prévues à l'article 165 du règlement financier applicable au budget général des communautés européennes ne s'	appliquent	 pas. 
fr_partut-ud-972	Cette aide finance des projets de renforcement des institutions et de petits investissements 	limités	 qui sont accessoires à ceux-ci. 
fr_partut-ud-978	Les mesures ainsi décidées sont immédiatement applicables, tiennent compte des intérêts de toutes les parties 	concernées	 et n'entraînent pas de contrôles aux frontières. 
fr_partut-ud-978	Les mesures ainsi 	décidées	 sont immédiatement applicables, tiennent compte des intérêts de toutes les parties concernées et n'entraînent pas de contrôles aux frontières. 
fr_partut-ud-981	Les mesures sont maintenues pendant la durée strictement nécessaire et, en tout état de cause, sont levées lorsque l'engagement correspondant est 	rempli	. 
fr_partut-ud-982	Elles peuvent cependant être appliquées au-delà de la période visée au premier alinéa tant que les engagements correspondants n'ont pas été 	remplis	. 
fr_partut-ud-983	La commission peut adapter les mesures arrêtées en fonction de la mesure dans laquelle le nouvel état membre 	concerné	 remplit ses engagements. 
fr_partut-ud-983	La commission peut adapter les mesures 	arrêtées	 en fonction de la mesure dans laquelle le nouvel état membre concerné remplit ses engagements. 
fr_partut-ud-984	Les mesures sont maintenues pendant la durée strictement nécessaire et, en tout état de cause, sont levées dès que le manquement constaté est 	corrigé	. 
fr_partut-ud-984	Les mesures sont maintenues pendant la durée strictement nécessaire et, en tout état de cause, sont levées dès que le manquement 	constaté	 est corrigé. 
fr_partut-ud-991	Le mandat des membres ainsi 	nommés	 expire en même temps que celui des membres qui sont en fonction au moment de l'adhésion. 
fr_partut-ud-1000	Les règlements de procédure ainsi 	adaptés	 sont soumis à l'approbation du conseil. 
fr_partut-ud-1002	Le mandat des membres ainsi 	nommés	 expire en même temps que celui des membres qui sont en fonction au moment de l'adhésion. 
fr_partut-ud-1003	Le mandat des nouveaux membres 	nommés	 expire en même temps que celui des membres qui sont en fonction au moment de l'adhésion. 
fr_partut-ud-1006	Lorsque ces dérogations sont arrêtées après l'adhésion, elles peuvent être 	appliquées	 à compter de la date d'adhésion. 
fr_partut-ud-1007	Lorsque ces adaptations sont adoptées après l'adhésion, elles peuvent être 	appliquées	 à compter de la date d'adhésion. 
fr_partut-ud-1012	Tant que cet accord n'est pas 	conclu	, dans la mesure où il s'applique provisoirement. 
fr_partut-ud-1015	une superficie maximale garantie de 829229 ha est ainsi 	établie	. 
fr_partut-ud-1015	une superficie maximale 	garantie	 de 829229 ha est ainsi établie. 
fr_partut-ud-1019	Une fois ce délai 	écoulé	, toute aide jugée incompatible avec ces orientations est considérée comme une aide nouvelle. 
