sent_id	left_context	pivot	right_context
fr_partut-ud-19	reproduire l'Oeuvre, 	incorporer	 l'Oeuvre dans une ou plusieurs oeuvres dites derivées et reproduire l'oeuvre telle qu'incorporée dans les dites oeuvres dites collectives; 
fr_partut-ud-21	distribuer des exemplaires ou enregistrements, présenter, 	représenter	 ou communiquer l'oeuvre au public par tout procédé technique, y compris incorporée dans des oeuvres collectives; 
fr_partut-ud-21	distribuer des exemplaires ou enregistrements, 	présenter	, représenter ou communiquer l'oeuvre au public par tout procédé technique, y compris incorporée dans des oeuvres collectives; 
fr_partut-ud-22	Distribuer des exemplaires ou phonogrammes, présenter, 	représenter	 ou communiquer au public des oeuvres dites derivées par tout procédé technique; 
fr_partut-ud-22	Distribuer des exemplaires ou phonogrammes, 	présenter	, représenter ou communiquer au public des oeuvres dites derivées par tout procédé technique; 
fr_partut-ud-23	lorsque l'Oeuvre est une base de données, 	extraire	 et réutiliser des parties substantielles de l'oeuvre. 
fr_partut-ud-32	L'acceptant ne peut pas reproduire, distribuer, 	représenter	 ou communiquer au public l'oeuvre, y compris par voie numérique, en utilisant une mesure technique de contrôle d'accès ou de contrôle d'utilisation qui serait contradictoire avec les termes de cet accord contractuel. 
fr_partut-ud-32	L'acceptant ne peut pas reproduire, 	distribuer	, représenter ou communiquer au public l'oeuvre, y compris par voie numérique, en utilisant une mesure technique de contrôle d'accès ou de contrôle d'utilisation qui serait contradictoire avec les termes de cet accord contractuel. 
fr_partut-ud-34	Si l'acceptant crée une oeuvre dite collective, à la demande de tout offrant, il devra, dans la mesure du possible, 	retirer	 de l'oeuvre dite collective toute référence au dit offrant, comme demandé. 
fr_partut-ud-35	Si l'acceptant crée une oeuvre dite dérivée, à la demande de tout offrant, il devra, dans la mesure du possible, 	retirer	 de l'oeuvre dite dérivée toute référence au dit offrant, comme demandé. 
fr_partut-ud-36	L'acceptant peut reproduire, distribuer, 	représenter	 ou communiquer au public une oeuvre dite dérivée y compris par voie numérique uniquement sous les termes de ce contrat, ou d'une version ultérieure de ce contrat comprenant les mêmes options du contrat que le présent contrat, ou un contrat Creative Commons Icommons comprenant les mêmes options du contrat que le présent contrat (par exemple paternité-pas d'utilisation commerciale-Partage des conditions initiales à l'Identique 2.0 Japon). 
fr_partut-ud-36	L'acceptant peut reproduire, 	distribuer	, représenter ou communiquer au public une oeuvre dite dérivée y compris par voie numérique uniquement sous les termes de ce contrat, ou d'une version ultérieure de ce contrat comprenant les mêmes options du contrat que le présent contrat, ou un contrat Creative Commons Icommons comprenant les mêmes options du contrat que le présent contrat (par exemple paternité-pas d'utilisation commerciale-Partage des conditions initiales à l'Identique 2.0 Japon). 
fr_partut-ud-38	L'acceptant ne peut pas reproduire, distribuer, 	représenter	 ou communiquer au public y compris par voie numérique l'oeuvre dite dérivée en utilisant une mesure technique de contrôle d'accès ou de contrôle d'utilisation qui serait contradictoire avec les termes de cet accord contractuel. 
fr_partut-ud-38	L'acceptant ne peut pas reproduire, 	distribuer	, représenter ou communiquer au public y compris par voie numérique l'oeuvre dite dérivée en utilisant une mesure technique de contrôle d'accès ou de contrôle d'utilisation qui serait contradictoire avec les termes de cet accord contractuel. 
fr_partut-ud-41	Dans la mesure du possible, l'adresse Internet ou Identifiant Uniforme de Ressource (URI), s'il existe, 	spécifié	 par l'offrant comme associé à l'oeuvre, à moins que cette adresse ne renvoie pas aux informations légales (paternité et conditions d'utilisation de l'oeuvre). 
fr_partut-ud-44	Cependant, dans le cas d'une oeuvre dite dérivée ou d'une oeuvre dite collective, ces informations doivent, au minimum, 	apparaître	 à la place et de manière aussi visible que celles à laquelle apparaissent les informations de même nature. 
fr_partut-ud-48	À l'exception des garanties d'ordre public imposées par la loi applicable et des réparations imposées par le régime de la responsabilité vis-à-vis d'un tiers en raison de la violation des garanties prévues par l'article 5 du présent contrat, l'offrant ne sera en aucun cas tenu responsable vis-à-vis de l'acceptant, sur la base d'aucune théorie légale ni en raison de aucun préjudice direct, indirect, matériel ou moral, 	résultant	 de l'exécution du présent contrat ou de l'utilisation de l'oeuvre, y compris dans l'hypothèse où l'offrant avait connaissance de la possible existence d'un tel préjudice. 
fr_partut-ud-75	(Le parlement, debout, 	observe	 une minute de silence). 
fr_partut-ud-88	C'est exactement à ce moment-là que vous pourrez, en effet, si vous le souhaitez, 	soulever	 cette question, c'est-à-dire jeudi avant le début de la présentation du rapport. 
fr_partut-ud-104	Elle sera, je l'espère, 	examinée	 dans un esprit positif. 
fr_partut-ud-115	Les services compétents ne les ont pas inclues à l'ordre du jour, 	avançant	 que des réponses avaient déjà été apportées lors d'une précédente session. 
fr_partut-ud-129	Cet engagement est important dans la mesure où la commission est un organisme qui détient, conformément aux traités, le monopole de l'initiative et qui, par conséquent, 	décide	 pour l'essentiel quelle sera l'activité politique et législative de ce parlement au cours des cinq prochaines années. 
fr_partut-ud-134	Les événements qui se sont produits la semaine dernière ­ qui sont nés en marge de la conférence des présidents et se servent d'elle dans le seul but de corroborer et de ratifier des décisions prises en dehors de celle-ci ­ 	créent	 un dilemme: 
fr_partut-ud-166	Monsieur Cox, monsieur Hänsch, 	est	-ce que cela vous convient? 
fr_partut-ud-210	Les normes imposées à cet effet dans une autre directive, 95/35/CE, 	semblent	 suffisamment adéquates pour informer les gens de manière responsable de l'organisation du transport de marchandises dangereuses. 
fr_partut-ud-228	Monsieur le président, je voudrais tout d'abord féliciter le rapporteur, M. Koch, de son magnifique travail et de sa collaboration positive avec la commission pour améliorer les textes, 	présenter	 ce rapport et cette proposition; 
fr_partut-ud-231	La position commune inclut pratiquement tous les amendements acceptés par la commission, harmonise les exigences minimales applicables aux examens des conseillers à la sécurité et, en deuxième lecture, nous pouvons accepter la date proposée, bien plus réaliste que celle projetée au départ par la commission, 	sachant	 que cela fait déjà plusieurs années que nous débattons cette question. 
fr_partut-ud-231	La position commune inclut pratiquement tous les amendements acceptés par la commission, 	harmonise	 les exigences minimales applicables aux examens des conseillers à la sécurité et, en deuxième lecture, nous pouvons accepter la date proposée, bien plus réaliste que celle projetée au départ par la commission, sachant que cela fait déjà plusieurs années que nous débattons cette question. 
fr_partut-ud-235	En ce sens, je voudrais également aborder très brièvement les problèmes des tunnels, auxquels mm. Rack et Swoboda ont fait référence, et qui, dans le cas de l'Autriche, 	constituent	 sans aucun doute un sujet très sensible, raison pour laquelle il est nécessaire de faire des efforts pour voir comment accroître leur sécurité. 
fr_partut-ud-255	Elle ne fait que prolonger les réglementations transitoires en repoussant les délais, 	supprime	 des dispositions qui ont cessé d'être pertinentes et règle les procédures pour ce qui est a) des transports ad hoc de marchandises dangereuses et b) de la promulgation de dispositions nationales moins strictes, en particulier pour le transport de quantités très réduites de marchandises dangereuses dans des zones strictement délimitées. 
fr_partut-ud-272	En Laponie aussi, les gens sont favorables à l'Union Européenne, 	pensons	 donc à eux. 
fr_partut-ud-304	Monsieur le Président, je suis particulièrement ravi de ce que ma première intervention au Parlement européen porte sur ce que la région du Royaume-uni que je représente au sein de ce Parlement, à savoir le pays de Galles, 	considère	 comme le sujet le plus important. 
fr_partut-ud-306	Il est clair que nombreux sont ceux qui, au pays de Galles, 	voient	 le programme de fonds structurels comme un moyen pour enrayer certaines des grandes difficultés auxquelles nous sommes indubitablement confrontés. 
fr_partut-ud-309	C'est pourquoi je voudrais souligner certains points que la commission devrait, d'après moi, 	placer	 au premier plan. 
fr_partut-ud-334	Monsieur le président, monsieur le commissaire, mesdames et messieurs les députés, la proposition présentée par la commission, 	remplissant	 ainsi son mandat, est, de l'avis de la commission de l'agriculture et du développement rural, un point de départ raisonnable. 
fr_partut-ud-337	Ceci, ajouté aux déficiences des réseaux d'infrastructures et de services et à une offre d'emploi généralement très limitée et tout au plus saisonnière et peu diversifiée, 	accentuent	 l'exode rural. 
fr_partut-ud-337	Ceci, 	ajouté	 aux déficiences des réseaux d'infrastructures et de services et à une offre d'emploi généralement très limitée et tout au plus saisonnière et peu diversifiée, accentuent l'exode rural. 
fr_partut-ud-352	Dans nos amendements, nous avons souligné l'importance que nous accordons à la création de synergies nécessaires entre les fonds structurels, le fonds de cohésion et les initiatives communautaires, de telle sorte que leur application se reflète au mieux, de la manière la plus rentable, dans l'élimination progressive des inégalités entre les régions et dans la création de postes de travail, ce qui, en définitive, 	correspond	 aux deux objectifs fondamentaux des fonds dont nous sommes en train de parler. 
fr_partut-ud-391	Monsieur le président, nous ne devrions pas perdre de vue que l'objectif principal et stratégique des fonds structurels et de cohésion, et de leur coordination, 	est	 de parvenir à la cohésion économique et sociale. 
fr_partut-ud-413	Le fond social a sans aucun doute amélioré nos institutions du troisième niveau, 	financé	 nos programmes de troisième cycle et mis en place des globaux en vue de lutter contre le chômage des jeunes et de longue durée, d'aider ceux qui interrompent prématurément leur scolarité et d'améliorer le niveau d'alphabétisation des adultes. 
fr_partut-ud-449	Or, la commission, 	tenue	 de présenter des orientations, ne le fait qu'avec regret et de façon floue. 
fr_partut-ud-454	Dès lors, l'Europe dans son ensemble, et chacun des états membres en particulier, 	devra	 exploiter au mieux toutes ses ressources et toutes ses capacités, et donc également les fonds structurels disponibles. 
fr_partut-ud-455	Pour ce faire, il faut une Commission européenne qui, au-delà de ses bonnes intentions, 	clarifie	 ses lignes directrices et s'engage un maximum dans le contrôle de l'utilisation de ces ressources par les états membres. 
fr_partut-ud-490	Lorsque vous créez un mot de passe, 	utilisez	 une combinaison de lettres, chiffres et marques de ponctuation, et un minimum de six caractères. 
fr_partut-ud-498	Dans le menu de la colonne de gauche, 	cliquez	 sur sécurité. 
fr_partut-ud-535	Une présence sur Facebook par l'intermédiaire des Page ou des évènements, en plus des publicités, 	peut	 vous permettre de convertir votre message publicitaire en «recommandation» à l'aide de contenu des amis de l'utilisateur déjà affiliés à vos produits. 
fr_partut-ud-549	Vous pouvez, pour chaque personne, choisir de ne pas voir les activités concernant les jeux, 	voir	 les photos ou limiter les actualités aux évènements marquants uniquement. 
fr_partut-ud-549	Vous pouvez, pour chaque personne, 	choisir	 de ne pas voir les activités concernant les jeux, voir les photos ou limiter les actualités aux évènements marquants uniquement. 
fr_partut-ud-564	Pour en apprendre plus sur le bouton ""s'abonner"", 	consultez	 les Aide. 
fr_partut-ud-574	En tant qu'approche préventive, 	visant	 à optimiser les performances environnementales des produits tout en conservant leur qualité d'usage, elle présente des opportunités nouvelles et réelles pour le fabricant, le consommateur et la société dans son ensemble. 
fr_partut-ud-589	(11) L'approche établie dans le livre vert sur la politique intégrée de produits, qui est l'un des principaux éléments novateurs du sixième programme d'action communautaire pour l'environnement, 	vise	 à réduire l'impact environnemental du produit tout au long de son cycle de vie. 
fr_partut-ud-597	(15) Les produits ou technologies les plus performants disponibles sur le marché, y compris sur les marchés internationaux, 	étant	 à prendre pour référence, le niveau des exigences d'écoconception devrait être établi sur la base d'analyses technique, économique et environnementale. 
fr_partut-ud-602	L'introduction d'objectifs intermédiaires contribue à une meilleure prédiction de l'évolution de la politique, 	permet	 d'adapter les cycles de développement du produit et facilite la planification à long terme pour les parties intéressées. 
fr_partut-ud-607	(19) Le chapitre 6 de la communication de la commission intitulée ""les accords environnementaux conclus au niveau communautaire dans le cadre du plan d'action"" simplifier et améliorer l'environnement réglementaire ""	pourrait	 fournir des orientations utiles pour évaluer l'autorégulation de l'industrie dans le cadre de la présente directive. 
fr_partut-ud-607	(19) Le chapitre 6 de la communication de la commission intitulée ""les accords environnementaux conclus au niveau communautaire dans le cadre du plan d'action"" 	simplifier	 et améliorer l'environnement réglementaire ""pourrait fournir des orientations utiles pour évaluer l'autorégulation de l'industrie dans le cadre de la présente directive. 
fr_partut-ud-614	(24) Il convient d'accorder une considération particulière aux modules et règles destinés à être utilisés dans les directives d'harmonisation technique qui sont prévus par la décision 93/465/CEE du Conseil du 22 juillet 1993 concernant les modules relatifs aux différentes phases des procédures d'évaluation de la conformité et les règles d'apposition et d'utilisation du marquage «CE» de conformité, 	destinés	 à être utilisés dans les directives d'harmonisation technique (1). 
fr_partut-ud-620	(27) 	Sachant	 qu'il importe d'éviter la non-conformité, les états membres doivent veiller à ce que les moyens nécessaires pour une surveillance efficace du marché soient disponibles. 
fr_partut-ud-631	La résolution du Conseil du 28 octobre 1999 sur le rôle de la normalisation en Europe (2) 	recommandait	 que la commission examine si le principe de la nouvelle approche pouvait être étendu aux secteurs qui ne sont pas encore couverts, en vue d'améliorer et de simplifier la législation dans tous les cas où cela est possible. 
fr_partut-ud-634	(34) Étant donné que la directive 92/42/CEE du conseil du 21 mai 1992 concernant les exigences de rendement pour les nouvelles chaudières à eau chaude alimentées en combustibles liquides ou gazeux (9), la directive 96/57/CE du parlement européen et du conseil du 3 septembre 1996 concernant les exigences en matière de rendement énergétique des réfrigérateurs, congélateurs et appareils combinés électriques à usage ménager (10) et la directive 2000/55/CE du parlement européen et du conseil du 18 septembre 2000 établissant des exigences de rendement énergétique applicables aux ballasts pour l'éclairage fluorescent (11) 	contiennent	 déjà des dispositions relatives à la révision des exigences d'efficacité énergétique, elles devraient être intégrées dans le présent cadre. 
fr_partut-ud-648	et - une communication sur l'opportunité de poursuivre et adapter le programme, 	accompagnée	 d'une proposition appropriée. 
fr_partut-ud-679	- la coopération entre les institutions européennes/organes (Commission/OLAF, BCE et Europol) 	doit	 être encore accrue de manière à éliminer tout chevauchement entre les différents programmes et à améliorer la coordination entre les principaux acteurs (services répressifs, banques, ministère public) dans la lutte contre la contrefaçon de l'euro; 
fr_partut-ud-698	À cet égard, le rapport d'évaluation (p.10 et 11) 	indique	 que, jusqu'en mars 2004, 65% des participants provenaient essentiellement des services répressifs. 
fr_partut-ud-708	La BCE, la Commission, Europol et, dans certains cas, Eurojust, Interpol et les services secrets américains, 	assurent	 une participation aux actions Pericles. 
fr_partut-ud-711	Cependant, un certain nombre d'actions ont été organisées dans des pays tiers ou candidats, 	montrant	 la nécessité de protéger l'euro. 
fr_partut-ud-733	- de former/	informer	 le nouveau personnel et d'étendre la formation aux secteurs qui ont moins bénéficié du programme Pericles, à savoir les agents financiers, le ministère public et les techniciens; 
fr_partut-ud-740	Considérant que la méconnaissance et le mépris des droits de l'homme ont conduit à des actes de barbarie qui révoltent la conscience de l'humanité et que l'avènement d'un monde où les êtres humains seront libres de parler et de croire, 	libérés	 de la terreur et de la misère, a été proclamé comme la plus haute aspiration de l'homme. 
fr_partut-ud-746	L'Assemblée Générale proclame la présente Déclaration Universelle des Droits de l'Homme comme l'idéal commun à atteindre par tous les peuples et toutes les nations afin que tous les individus et tous les organes de la société, 	ayant	 cette déclaration constamment à l'esprit, s'efforcent, par l'enseignement et l'éducation, de développer le respect de ces droits et libertés et d'en assurer, par des mesures progressives d'ordre national et international, la reconnaissance et l'application universelles et effectives, tant parmi les populations des Etats membres eux-mêmes que parmi celles des territoires placés sous leur juridiction. 
fr_partut-ud-760	Nul ne peut être arbitrairement arrêté, 	détenu	 ou exilé. 
fr_partut-ud-777	1. Toute personne, aussi bien seule qu'en collectivité, 	a	 droit à la propriété. 
fr_partut-ud-788	Toute personne, en tant que membre de la société, 	a	 droit à la sécurité sociale; 
fr_partut-ud-796	Tous les enfants, qu'ils soient nés dans le mariage ou hors mariage, 	jouissent	 de la même protection sociale. 
fr_partut-ud-818	À cette époque, Cannery Row, 	avait	 le plus grand complexe de conserveries de toute la côte ouest. 
fr_partut-ud-7	L'oeuvre (telle que définie ci-dessous) est mise à disposition selon les termes du présent contrat appelé Contrat Public Creative Commons (	dénommé	 ici «CPCC» ou «Contrat»). 
fr_partut-ud-85	Le paragraphe 6 du rapport Cunha sur les programmes d'orientation pluriannuels, qui sera soumis au parlement ce jeudi, 	propose	 d'introduire des sanctions applicables aux pays qui ne respectent pas les objectifs annuels de réduction de leur flotte. 
fr_partut-ud-465	De plus, si vous choisissez d'utiliser Facebook à partir de votre téléphone mobile, 	notez	 que vous êtes responsable des frais associés à l'utilisation d'Internet et/ou aux SMS, selon les termes de votre opérateur de téléphonie mobile. 
fr_partut-ud-485	Pour vous inscrire et créer un tout nouveau compte, 	saisissez	 votre nom, votre date d'anniversaire, votre sexe et votre adresse électronique au format. 
fr_partut-ud-929	Prototaxites, 	couché	, mesurait environ 90 cm de hauteur. 
fr_partut-ud-937	Ainsi, la perspective de champignons existant ailleurs sur d'autres planètes, est, je crois, 	courue	 d'avance; 
fr_partut-ud-942	Le mycélium, dans de bonnes conditions, 	produit	 un champignon - il traverse le sol avec une férocité telle qu'il peut briser l'asphalte. 
fr_partut-ud-673	- le programme doit être reconduit pour une nouvelle période d'au moins quatre ans, 	assortie	 d'un budget équivalent (1 million d'euros par an) et doit porter sur les mêmes mesures et les mêmes destinataires; 
fr_partut-ud-773	1. À partir de l'âge nubile, l'homme et la femme, sans aucune restriction quant à la race, la nationalité ou la religion, 	ont	 le droit de se marier et de fonder une famille. 
fr_partut-ud-955	Le texte du traité établissant une constitution pour l'Europe, 	rédigé	 en langues bulgare et roumaine, est annexé au présent traité. 
fr_partut-ud-978	Les mesures ainsi décidées sont immédiatement applicables, 	tiennent	 compte des intérêts de toutes les parties concernées et n'entraînent pas de contrôles aux frontières. 
fr_partut-ud-999	Le tribunal, en accord avec la Cour de justice, 	apporte	 à son règlement de procédure les adaptations rendues nécessaires par l'adhésion. 
fr_partut-ud-1010	Le texte de ce traité, 	établi	 en langues bulgare et roumaine, est joint au présent protocole. 
fr_partut-ud-1011	Ces textes font foi dans les mêmes conditions que les textes du traité visé au premier alinéa, 	établis	 dans les langues actuelles. 
